Zotu2	Eukaryota;Oomycota;unknown;Peronosporales;Peronosporaceae;Phytophthora;	Eukaryota;unknown;Synurophyceae;Synurales;Mallomonadaceae;Synura;Synura_petersenii;
Zotu3	Eukaryota;Arthropoda;Hexanauplia;Calanoida;Diaptomidae;Leptodiaptomus;Leptodiaptomus_minutus;	Eukaryota;Arthropoda;Hexanauplia;Calanoida;Diaptomidae;Leptodiaptomus;Leptodiaptomus_minutus;
Zotu4	Unknown	Eukaryota;Chlorophyta;Trebouxiophyceae;unknown;Coccomyxaceae;Medakamo;Medakamo_hakoo;
Zotu5	Eukaryota;Rotifera;Eurotatoria;Ploima;	Eukaryota;Rotifera;Eurotatoria;Ploima;Brachionidae;Keratella;Keratella_sp._STE97;
Zotu8	Eukaryota;Rotifera;Eurotatoria;Ploima;Synchaetidae;Polyarthra;Polyarthra_dolichoptera_complex_sp._UO-2013;	Eukaryota;Rotifera;Eurotatoria;Ploima;Synchaetidae;Polyarthra;Polyarthra_dolichoptera_complex_sp._UO-2013;
Zotu9	Eukaryota;Rotifera;Eurotatoria;Ploima;	Eukaryota;Rotifera;Eurotatoria;Ploima;Trichocercidae;unknown;Trichocercidae_sp._SHCX151203c;
Zotu12	Eukaryota;Rotifera;Eurotatoria;Ploima;Synchaetidae;Polyarthra;	Eukaryota;Rotifera;Eurotatoria;Ploima;Synchaetidae;Polyarthra;Polyarthra_sp._WM-2017a;
Zotu13	Eukaryota;unknown;Raphidophyceae;Chattonellales;Chattonellaceae;Chattonella;Chattonella_marina;	Eukaryota;unknown;Raphidophyceae;Chattonellales;Chattonellaceae;Chattonella;Chattonella_marina;
Zotu15	Eukaryota;unknown;Raphidophyceae;Chattonellales;Chattonellaceae;Chattonella;Chattonella_marina;	Eukaryota;unknown;Raphidophyceae;Chattonellales;Chattonellaceae;Chattonella;Chattonella_marina;
Zotu16	Eukaryota;unknown;Raphidophyceae;Chattonellales;Chattonellaceae;Chattonella;Chattonella_marina;	Eukaryota;unknown;Raphidophyceae;Chattonellales;Chattonellaceae;Chattonella;Chattonella_marina;
Zotu17	Eukaryota;unknown;Raphidophyceae;Chattonellales;Chattonellaceae;Chattonella;Chattonella_marina;	Eukaryota;unknown;Raphidophyceae;Chattonellales;Chattonellaceae;Chattonella;Chattonella_marina;
Zotu18	Unknown	Eukaryota;Rotifera;Eurotatoria;Ploima;Asplanchnidae;Asplanchna;Asplanchna_brightwellii;
Zotu19	Eukaryota;Rotifera;Eurotatoria;Ploima;	Eukaryota;Rotifera;Eurotatoria;Ploima;Brachionidae;Kellicottia;Kellicottia_bostoniensis;
Zotu21	Eukaryota;Chordata;Mammalia;Carnivora;Canidae;Canis;Canis_lupus;	Eukaryota;Chordata;Mammalia;Carnivora;Canidae;Canis;Canis_lupus;
Zotu23	Eukaryota;Rotifera;Eurotatoria;Ploima;	Eukaryota;Rotifera;unknown;unknown;unknown;unknown;Rotifera_environmental_sample;
Zotu24	Eukaryota;unknown;Raphidophyceae;Chattonellales;Chattonellaceae;Chattonella;Chattonella_marina;	Eukaryota;unknown;Raphidophyceae;Chattonellales;Chattonellaceae;Chattonella;Chattonella_marina;
Zotu26	Eukaryota;Rotifera;	Eukaryota;Rotifera;Eurotatoria;Ploima;Trichocercidae;Trichocerca;Trichocerca_sp._WM-2017b;
Zotu27	Eukaryota;Chordata;Mammalia;Primates;Hominidae;Homo;Homo_sapiens;	Eukaryota;Chordata;Mammalia;Primates;Hominidae;Homo;Homo_sapiens;
Zotu28	Eukaryota;Rotifera;Eurotatoria;Ploima;	Eukaryota;Rotifera;Eurotatoria;Ploima;Trichocercidae;Trichocerca;Trichocerca_sp._WM-2017d;
Zotu29	Unknown	Eukaryota;Chlorophyta;Trebouxiophyceae;unknown;unknown;Choricystis;Choricystis_sp._odSpoLacu1;
Zotu30	Eukaryota;Rotifera;Eurotatoria;Ploima;	Eukaryota;Rotifera;Eurotatoria;Ploima;Brachionidae;Keratella;Keratella_sp._STE97;
Zotu32	Eukaryota;unknown;	Eukaryota;unknown;Chrysophyceae;Chromulinales;Dinobryaceae;Dinobryon;Dinobryon_similis;
Zotu34	Eukaryota;Arthropoda;Hexanauplia;Calanoida;Diaptomidae;Leptodiaptomus;Leptodiaptomus_minutus;	Eukaryota;Arthropoda;Hexanauplia;Calanoida;Diaptomidae;Leptodiaptomus;Leptodiaptomus_minutus;
Zotu35	Eukaryota;unknown;	Eukaryota;unknown;Chrysophyceae;Chromulinales;Chromulinaceae;Pedospumella;Pedospumella_sp.;
Zotu36	Eukaryota;Gastrotricha;unknown;Chaetonotida;Chaetonotidae;	Eukaryota;Gastrotricha;unknown;Chaetonotida;Chaetonotidae;Lepidodermella;Lepidodermella_broa;
Zotu37	Bacteria;Pseudomonadota;Alphaproteobacteria;Rickettsiales;Rickettsiaceae;Candidatus_Megaera;	Bacteria;Pseudomonadota;Alphaproteobacteria;Rickettsiales;Rickettsiaceae;Candidatus_Megaera;Candidatus_Megaira_endosymbiont_of_Mesostigma_viride;
Zotu38	Eukaryota;unknown;Raphidophyceae;Chattonellales;Chattonellaceae;Chattonella;Chattonella_marina;	Eukaryota;unknown;Raphidophyceae;Chattonellales;Chattonellaceae;Chattonella;Chattonella_marina;
Zotu39	Eukaryota;Arthropoda;Hexanauplia;Calanoida;	Eukaryota;Arthropoda;Hexanauplia;Calanoida;Pontellidae;unknown;Pontellidae_sp._BIOUG30454-F04;
Zotu40	Eukaryota;unknown;Raphidophyceae;Chattonellales;Chattonellaceae;Chattonella;Chattonella_marina;	Eukaryota;unknown;Chrysophyceae;Chromulinales;Dinobryaceae;Dinobryon;Dinobryon_similis;
Zotu42	Eukaryota;Rotifera;Eurotatoria;Ploima;Asplanchnidae;Asplanchna;	Eukaryota;Rotifera;Eurotatoria;Ploima;Asplanchnidae;Asplanchna;Asplanchna_priodonta;
Zotu43	Eukaryota;Bacillariophyta;	Eukaryota;Bacillariophyta;Coscinodiscophyceae;Thalassiosirales;Thalassiosiraceae;Thalassiosira;Thalassiosira_pseudonana;
Zotu44	Eukaryota;Arthropoda;Branchiopoda;Diplostraca;Holopediidae;Holopedium;Holopedium_glacialis;	Eukaryota;Arthropoda;Branchiopoda;Diplostraca;Holopediidae;Holopedium;Holopedium_glacialis;
Zotu45	Eukaryota;Chordata;Mammalia;Artiodactyla;Suidae;Sus;Sus_scrofa;	Eukaryota;Chordata;Mammalia;Artiodactyla;Suidae;Sus;Sus_scrofa;
Zotu46	Eukaryota;Oomycota;unknown;Peronosporales;Peronosporaceae;	Eukaryota;unknown;Phaeophyceae;Ectocarpales;Scytosiphonaceae;Petalonia;Petalonia_tenella;
Zotu47	Eukaryota;Arthropoda;Hexanauplia;Calanoida;	Eukaryota;Arthropoda;Hexanauplia;Calanoida;Pontellidae;unknown;Pontellidae_sp._BIOUG30454-F04;
Zotu49	Eukaryota;Rotifera;Eurotatoria;Ploima;Trichocercidae;Trichocerca;	Eukaryota;Rotifera;Eurotatoria;Ploima;Trichocercidae;Trichocerca;Trichocerca_sp._WM-2017d;
Zotu50	Eukaryota;unknown;Raphidophyceae;Chattonellales;Chattonellaceae;Chattonella;Chattonella_marina;	Eukaryota;unknown;Raphidophyceae;Chattonellales;Chattonellaceae;Chattonella;Chattonella_marina;
Zotu52	Eukaryota;unknown;Phaeophyceae;Ectocarpales;Chordariaceae;	Eukaryota;unknown;Phaeophyceae;Ectocarpales;Chordariaceae;Leptonematella;Leptonematella_fasciculata;
Zotu55	Eukaryota;unknown;	Eukaryota;unknown;Synurophyceae;Synurales;Mallomonadaceae;Synura;Synura_petersenii;
Zotu57	Eukaryota;unknown;Phaeophyceae;Ectocarpales;	Eukaryota;unknown;Phaeophyceae;Ectocarpales;Chordariaceae;Laminarionema;Laminarionema_elsbetiae;
Zotu58	Eukaryota;Chlorophyta;Trebouxiophyceae;unknown;	Eukaryota;Chlorophyta;Trebouxiophyceae;unknown;unknown;Choricystis;Choricystis_parasitica;
Zotu63	Eukaryota;Arthropoda;Branchiopoda;Diplostraca;Daphniidae;Daphnia;	Eukaryota;Arthropoda;Branchiopoda;Diplostraca;Daphniidae;Daphnia;Daphnia_dubia;
Zotu64	Eukaryota;unknown;Raphidophyceae;Chattonellales;Chattonellaceae;Chattonella;Chattonella_marina;	Eukaryota;unknown;Raphidophyceae;Chattonellales;Chattonellaceae;Chattonella;Chattonella_marina;
Zotu65	Eukaryota;Rotifera;Eurotatoria;Ploima;Asplanchnidae;Asplanchna;	Eukaryota;Rotifera;Eurotatoria;Ploima;Asplanchnidae;Asplanchna;Asplanchna_priodonta;
Zotu67	Eukaryota;Arthropoda;Hexanauplia;Calanoida;Diaptomidae;Leptodiaptomus;Leptodiaptomus_minutus;	Eukaryota;Arthropoda;Hexanauplia;Calanoida;Diaptomidae;Leptodiaptomus;Leptodiaptomus_minutus;
Zotu68	Unknown	Eukaryota;Arthropoda;Insecta;Hymenoptera;Formicidae;Adelomyrmex;Adelomyrmex_sp._SC02;
Zotu70	Eukaryota;unknown;Chrysophyceae;Chromulinales;	Eukaryota;unknown;Chrysophyceae;Chromulinales;Dinobryaceae;Dinobryon;Dinobryon_cylindricollarium;
Zotu71	Eukaryota;Rotifera;Eurotatoria;Ploima;Brachionidae;	Eukaryota;Rotifera;Eurotatoria;Ploima;Brachionidae;Keratella;Keratella_sp._STE97;
Zotu72	Eukaryota;Rotifera;Eurotatoria;Ploima;	Eukaryota;Rotifera;Eurotatoria;Ploima;Trichocercidae;Trichocerca;Trichocerca_sp._WM-2017d;
Zotu73	Eukaryota;unknown;Raphidophyceae;Chattonellales;Chattonellaceae;Chattonella;Chattonella_marina;	Eukaryota;unknown;Raphidophyceae;Chattonellales;Chattonellaceae;Chattonella;Chattonella_marina;
Zotu74	Eukaryota;Ascomycota;Sordariomycetes;Hypocreales;Hypocreaceae;Trichoderma;	Eukaryota;Ascomycota;Sordariomycetes;Hypocreales;Hypocreaceae;Trichoderma;Trichoderma_atroviride;
Zotu75	Eukaryota;unknown;Phaeophyceae;Ectocarpales;	Eukaryota;unknown;Chrysophyceae;Chromulinales;Chromulinaceae;Pedospumella;Pedospumella_sp._JBM19;
Zotu77	Eukaryota;unknown;Phaeophyceae;Ectocarpales;Scytosiphonaceae;Petalonia;Petalonia_fascia;	Eukaryota;unknown;Eustigmatophyceae;Eustigmatales;Monodopsidaceae;Nannochloropsis;Nannochloropsis_limnetica;
Zotu78	Eukaryota;Arthropoda;Branchiopoda;Diplostraca;Daphniidae;Daphnia;	Eukaryota;Arthropoda;Branchiopoda;Diplostraca;Daphniidae;Daphnia;Daphnia_dubia;
Zotu79	Eukaryota;Bacillariophyta;Coscinodiscophyceae;	Eukaryota;Bacillariophyta;Coscinodiscophyceae;Coscinodiscales;Coscinodiscaceae;Coscinodiscus;Coscinodiscus_wailesii;
Zotu80	Eukaryota;Oomycota;unknown;Peronosporales;Peronosporaceae;Phytophthora;	Eukaryota;Oomycota;unknown;Peronosporales;Peronosporaceae;Phytophthora;Phytophthora_tenuimura;
Zotu81	Bacteria;Pseudomonadota;Alphaproteobacteria;Rickettsiales;Rickettsiaceae;Candidatus_Megaera;	Bacteria;Pseudomonadota;Alphaproteobacteria;Rickettsiales;Rickettsiaceae;Candidatus_Megaera;Candidatus_Megaira_endosymbiont_of_Mesostigma_viride;
Zotu83	Eukaryota;Arthropoda;Hexanauplia;Calanoida;	Eukaryota;Arthropoda;Hexanauplia;Calanoida;Pontellidae;unknown;Pontellidae_sp._BIOUG30454-F04;
Zotu85	Eukaryota;Arthropoda;Hexanauplia;Calanoida;	Eukaryota;Arthropoda;Hexanauplia;Calanoida;Pontellidae;unknown;Pontellidae_sp._BIOUG30454-F04;
Zotu86	Eukaryota;unknown;Raphidophyceae;Chattonellales;Chattonellaceae;Chattonella;Chattonella_marina;	Eukaryota;unknown;Raphidophyceae;Chattonellales;Chattonellaceae;Chattonella;Chattonella_marina;
Zotu87	Eukaryota;Rotifera;Eurotatoria;Ploima;Synchaetidae;Polyarthra;	Eukaryota;Rotifera;Eurotatoria;Ploima;Synchaetidae;Polyarthra;Polyarthra_dolichoptera;
Zotu88	Eukaryota;Arthropoda;Insecta;Coleoptera;Staphylinidae;Quedius;Quedius_obliqueseriatus;	Bacteria;Pseudomonadota;Alphaproteobacteria;Rickettsiales;Anaplasmataceae;Candidatus_Mesenet;Candidatus_Mesenet_endosymbiont_of_Phosphuga_atrata;
Zotu89	Eukaryota;Rotifera;Eurotatoria;Ploima;Synchaetidae;Synchaeta;	Eukaryota;Rotifera;Eurotatoria;Ploima;Synchaetidae;Synchaeta;Synchaeta_lakowitziana;
Zotu91	Eukaryota;Bacillariophyta;Bacillariophyceae;Naviculales;Sellaphoraceae;Sellaphora;	Eukaryota;Bacillariophyta;Bacillariophyceae;Naviculales;Sellaphoraceae;Sellaphora;Sellaphora_cf._seminulum;
Zotu92	Eukaryota;Rotifera;Eurotatoria;Ploima;	Eukaryota;Rotifera;Eurotatoria;Ploima;Trichocercidae;Trichocerca;Trichocerca_multicrinis;
Zotu93	Eukaryota;Bacillariophyta;	Eukaryota;Bacillariophyta;Mediophyceae;Lithodesmiales;Lithodesmiaceae;Helicotheca;Helicotheca_tamesis;
Zotu94	Eukaryota;unknown;	Eukaryota;unknown;Chrysophyceae;Chromulinales;Chromulinaceae;Pedospumella;Pedospumella_sp.;
Zotu95	Eukaryota;Oomycota;unknown;Peronosporales;Peronosporaceae;Phytophthora;	Eukaryota;Oomycota;unknown;Saprolegniales;Saprolegniaceae;Achlya;Achlya_sparrowii;
Zotu96	Eukaryota;unknown;	Eukaryota;unknown;Synurophyceae;Synurales;Mallomonadaceae;Synura;Synura_petersenii;
Zotu97	Eukaryota;Rotifera;Eurotatoria;Ploima;	Eukaryota;Rotifera;Eurotatoria;Ploima;Brachionidae;Brachionus;Brachionus_sp._BIOUG30063-G04;
Zotu98	Eukaryota;Rotifera;Eurotatoria;Ploima;	Eukaryota;Rotifera;Eurotatoria;Ploima;Synchaetidae;Polyarthra;Polyarthra_sp._WM-2017a;
Zotu99	Eukaryota;Arthropoda;Hexanauplia;Calanoida;	Eukaryota;Arthropoda;Hexanauplia;Calanoida;Pontellidae;unknown;Pontellidae_sp._BIOUG30454-F04;
Zotu100	Eukaryota;Rotifera;Eurotatoria;Ploima;	Eukaryota;Rotifera;Eurotatoria;Ploima;Trichocercidae;Trichocerca;Trichocerca_sp._WM-2017h;
Zotu101	Eukaryota;Bacillariophyta;Coscinodiscophyceae;	Eukaryota;Bacillariophyta;Coscinodiscophyceae;Melosirales;Melosiraceae;Melosira;Melosira_ambiqua;
Zotu102	Eukaryota;Rotifera;Eurotatoria;Ploima;	Eukaryota;Rotifera;Eurotatoria;Ploima;Trichocercidae;Trichocerca;Trichocerca_sp._WM-2017b;
Zotu103	Eukaryota;unknown;Dinophyceae;	Eukaryota;unknown;Dinophyceae;unknown;unknown;unknown;uncultured_dinoflagellate;
Zotu104	Eukaryota;unknown;	Eukaryota;unknown;Eustigmatophyceae;Eustigmatales;Monodopsidaceae;Nannochloropsis;Nannochloropsis_limnetica;
Zotu105	Eukaryota;Arthropoda;Hexanauplia;Calanoida;	Eukaryota;Arthropoda;Hexanauplia;Calanoida;Pontellidae;unknown;Pontellidae_sp._BIOUG30454-F04;
Zotu107	Eukaryota;Rotifera;Eurotatoria;Ploima;Brachionidae;Keratella;Keratella_cochlearis;	Eukaryota;Rotifera;Eurotatoria;Ploima;Brachionidae;Keratella;Keratella_cochlearis;
Zotu108	Eukaryota;Arthropoda;Hexanauplia;Calanoida;Diaptomidae;Leptodiaptomus;Leptodiaptomus_minutus;	Eukaryota;Arthropoda;Hexanauplia;Calanoida;Diaptomidae;Leptodiaptomus;Leptodiaptomus_minutus;
Zotu109	Eukaryota;unknown;Raphidophyceae;Chattonellales;Chattonellaceae;Chattonella;Chattonella_marina;	Eukaryota;unknown;Raphidophyceae;Chattonellales;Chattonellaceae;Chattonella;Chattonella_marina;
Zotu110	Eukaryota;Oomycota;unknown;	Eukaryota;unknown;unknown;Tsukubamonadida;Tsukubamonadidae;Tsukubamonas;Tsukubamonas_globosa;
Zotu111	Eukaryota;Bacillariophyta;	Eukaryota;Bacillariophyta;Coscinodiscophyceae;Coscinodiscales;Coscinodiscaceae;Coscinodiscus;Coscinodiscus_wailesii;
Zotu113	Unknown	Eukaryota;Chlorophyta;Trebouxiophyceae;unknown;unknown;Botryococcus;Botryococcus_braunii;
Zotu114	Eukaryota;Arthropoda;Insecta;Coleoptera;Staphylinidae;Quedius;Quedius_obliqueseriatus;	Eukaryota;Arthropoda;Insecta;Coleoptera;Staphylinidae;Quedius;Quedius_obliqueseriatus;
Zotu116	Unknown	Eukaryota;Rotifera;Eurotatoria;Flosculariaceae;Conochilidae;Conochilus;Conochilus_unicornis;
Zotu117	Eukaryota;Rotifera;	Eukaryota;Rotifera;Eurotatoria;Ploima;Gastropidae;Ascomorpha;Ascomorpha_ovalis_AEG1;
Zotu118	Eukaryota;	Eukaryota;Bacillariophyta;Coscinodiscophyceae;Melosirales;Melosiraceae;Melosira;Melosira_ambiqua;
Zotu119	Unknown	Eukaryota;Chlorophyta;Trebouxiophyceae;unknown;unknown;Botryococcus;Botryococcus_braunii;
Zotu120	Eukaryota;Oomycota;unknown;Peronosporales;Peronosporaceae;	Eukaryota;unknown;Phaeophyceae;Ectocarpales;Scytosiphonaceae;Petalonia;Petalonia_tenella;
Zotu121	Eukaryota;	Eukaryota;unknown;Bigyra;Bicosoecida;Cafeteriaceae;Cafeteria;Cafeteria_roenbergensis;
Zotu122	Eukaryota;Gastrotricha;unknown;Chaetonotida;Chaetonotidae;Chaetonotus;	Eukaryota;Gastrotricha;unknown;Chaetonotida;Chaetonotidae;Chaetonotus;Chaetonotus_cf._similis_TK106;
Zotu123	Bacteria;Pseudomonadota;Alphaproteobacteria;Rickettsiales;Rickettsiaceae;	Bacteria;Pseudomonadota;Alphaproteobacteria;Rickettsiales;Rickettsiaceae;Candidatus_Tisiphia;Candidatus_Tisiphia_endosymbiont_of_Thecophora_atra;
Zotu127	Eukaryota;Arthropoda;Hexanauplia;Calanoida;	Eukaryota;Arthropoda;Hexanauplia;Calanoida;Pontellidae;unknown;Pontellidae_sp._BIOUG30454-F04;
Zotu129	Eukaryota;Arthropoda;Insecta;Coleoptera;Staphylinidae;Quedius;Quedius_obliqueseriatus;	Eukaryota;Arthropoda;Insecta;Coleoptera;Staphylinidae;Quedius;Quedius_obliqueseriatus;
Zotu130	Eukaryota;Rotifera;Eurotatoria;Ploima;	Eukaryota;Rotifera;Eurotatoria;Ploima;Synchaetidae;Polyarthra;Polyarthra_vulgaris;
Zotu134	Eukaryota;unknown;Chrysophyceae;Chromulinales;Dinobryaceae;Dinobryon;Dinobryon_pediforme;	Eukaryota;unknown;Chrysophyceae;Chromulinales;Dinobryaceae;Dinobryon;Dinobryon_pediforme;
Zotu135	Eukaryota;unknown;Raphidophyceae;Chattonellales;Chattonellaceae;Chattonella;Chattonella_marina;	Eukaryota;unknown;Raphidophyceae;Chattonellales;Chattonellaceae;Chattonella;Chattonella_marina;
Zotu139	Eukaryota;Bacillariophyta;Bacillariophyceae;	Eukaryota;Bacillariophyta;Bacillariophyceae;Naviculales;Amphipleuraceae;Frustulia;Frustulia_vulgaris;
Zotu140	Eukaryota;	Eukaryota;unknown;Phaeophyceae;Ectocarpales;Scytosiphonaceae;Petalonia;Petalonia_tenella;
Zotu141	Eukaryota;Chlorophyta;Chlorophyceae;Chlamydomonadales;unknown;Limnomonas;Limnomonas_gaiensis;	Eukaryota;Chlorophyta;Chlorophyceae;Chlamydomonadales;unknown;Limnomonas;Limnomonas_spitsbergensis;
Zotu142	Eukaryota;unknown;	Eukaryota;unknown;Chrysophyceae;Chromulinales;Dinobryaceae;Dinobryon;Dinobryon_cylindricollarium;
Zotu144	Bacteria;Pseudomonadota;Betaproteobacteria;Nitrosomonadales;Nitrosomonadaceae;Nitrosomonas;	Bacteria;Pseudomonadota;Betaproteobacteria;Nitrosomonadales;Nitrosomonadaceae;Nitrosomonas;Nitrosomonas_ureae;
Zotu145	Eukaryota;Gastrotricha;unknown;Chaetonotida;Chaetonotidae;Chaetonotus;	Eukaryota;Gastrotricha;unknown;Chaetonotida;Chaetonotidae;Chaetonotus;Chaetonotus_aff._subtilis_3_MK-2019;
Zotu146	Eukaryota;	Eukaryota;Chlorophyta;Trebouxiophyceae;Chlorellales;Chlorellaceae;Marvania;Marvania_geminata;
Zotu147	Eukaryota;unknown;	Eukaryota;unknown;Chrysophyceae;Chromulinales;Dinobryaceae;Dinobryon;Dinobryon_similis;
Zotu148	Eukaryota;Gastrotricha;unknown;Chaetonotida;Chaetonotidae;Chaetonotus;	Eukaryota;Gastrotricha;unknown;Chaetonotida;Chaetonotidae;Aspidiophorus;Aspidiophorus_ophiodermus;
Zotu149	Eukaryota;Arthropoda;Insecta;Diptera;Chironomidae;	Eukaryota;Arthropoda;Insecta;Diptera;Chironomidae;Tanytarsus;Tanytarsus_sp._BBDIQ185-10;
Zotu151	Eukaryota;unknown;Raphidophyceae;Chattonellales;Chattonellaceae;Chattonella;Chattonella_marina;	Eukaryota;unknown;Raphidophyceae;Chattonellales;Chattonellaceae;Chattonella;Chattonella_marina;
Zotu152	Eukaryota;Rotifera;Eurotatoria;Ploima;	Eukaryota;Rotifera;Eurotatoria;Ploima;Trichocercidae;Trichocerca;Trichocerca_sp._WM-2017h;
Zotu153	Eukaryota;Gastrotricha;unknown;Chaetonotida;Chaetonotidae;Chaetonotus;	Eukaryota;Gastrotricha;unknown;Chaetonotida;Chaetonotidae;Chaetonotus;Chaetonotus_iratus;
Zotu154	Eukaryota;	Eukaryota;unknown;Phaeophyceae;Ectocarpales;Chordariaceae;Laminarionema;Laminarionema_elsbetiae;
Zotu156	Eukaryota;unknown;Phaeophyceae;Ectocarpales;Scytosiphonaceae;	Eukaryota;unknown;Phaeophyceae;Ectocarpales;Scytosiphonaceae;Manzaea;Manzaea_minuta;
Zotu157	Eukaryota;Rotifera;Eurotatoria;Ploima;	Eukaryota;Rotifera;Eurotatoria;Ploima;Asplanchnidae;Asplanchna;Asplanchna_sp.;
Zotu158	Eukaryota;unknown;Raphidophyceae;Chattonellales;Chattonellaceae;Chattonella;Chattonella_marina;	Eukaryota;unknown;Raphidophyceae;Chattonellales;Chattonellaceae;Chattonella;Chattonella_marina;
Zotu159	Unknown	Bacteria;Bacteroidota;Bacteroidia;Bacteroidales;unknown;unknown;Bacteroidales_bacterium;
Zotu160	Eukaryota;Chordata;Aves;Galliformes;Phasianidae;Meleagris;Meleagris_gallopavo;	Eukaryota;Chordata;Aves;Galliformes;Phasianidae;Meleagris;Meleagris_gallopavo;
Zotu163	Eukaryota;unknown;Raphidophyceae;Chattonellales;Chattonellaceae;Chattonella;Chattonella_marina;	Eukaryota;unknown;Raphidophyceae;Chattonellales;Chattonellaceae;Chattonella;Chattonella_marina;
Zotu164	Eukaryota;Gastrotricha;unknown;Chaetonotida;Chaetonotidae;	Eukaryota;Gastrotricha;unknown;Chaetonotida;Chaetonotidae;Chaetonotus;Chaetonotus_aff._daphnes_2_MK-2019;
Zotu171	Eukaryota;unknown;Raphidophyceae;Chattonellales;Chattonellaceae;Chattonella;Chattonella_marina;	Eukaryota;unknown;Raphidophyceae;Chattonellales;Chattonellaceae;Chattonella;Chattonella_marina;
Zotu172	Eukaryota;unknown;	Eukaryota;unknown;Phaeophyceae;Ectocarpales;Chordariaceae;Nemacystus;Nemacystus_decipiens;
Zotu174	Bacteria;Pseudomonadota;Alphaproteobacteria;Rickettsiales;Rickettsiaceae;Candidatus_Megaera;	Bacteria;Pseudomonadota;Alphaproteobacteria;Rickettsiales;Rickettsiaceae;Candidatus_Megaera;Candidatus_Megaera_polyxenophila;
Zotu175	Bacteria;Pseudomonadota;Alphaproteobacteria;Rickettsiales;Rickettsiaceae;Candidatus_Megaera;	Bacteria;Pseudomonadota;Alphaproteobacteria;Rickettsiales;Rickettsiaceae;Candidatus_Megaera;Candidatus_Megaira_endosymbiont_of_Mesostigma_viride;
Zotu176	Eukaryota;unknown;Chrysophyceae;Chromulinales;	Eukaryota;unknown;Chrysophyceae;Chromulinales;Dinobryaceae;Poteriospumella;Poteriospumella_sp.;
Zotu178	Eukaryota;unknown;Dinophyceae;	Eukaryota;unknown;Dinophyceae;unknown;unknown;unknown;uncultured_dinoflagellate;
Zotu181	Bacteria;Pseudomonadota;Alphaproteobacteria;Rickettsiales;Rickettsiaceae;	Bacteria;Pseudomonadota;Alphaproteobacteria;Rickettsiales;Rickettsiaceae;Candidatus_Tisiphia;Candidatus_Tisiphia_endosymbiont_of_Thecophora_atra;
Zotu183	Eukaryota;Oomycota;unknown;Peronosporales;Peronosporaceae;Phytophthora;	Eukaryota;Oomycota;unknown;Saprolegniales;Saprolegniaceae;Achlya;Achlya_sparrowii;
Zotu184	Eukaryota;Rotifera;Eurotatoria;Ploima;	Eukaryota;Rotifera;Eurotatoria;Ploima;Trichocercidae;Trichocerca;Trichocerca_sp._WM-2017h;
Zotu185	Eukaryota;unknown;Phaeophyceae;Ectocarpales;	Eukaryota;unknown;Chrysophyceae;Chromulinales;Chromulinaceae;Pedospumella;Pedospumella_sinomuralis;
Zotu186	Eukaryota;unknown;Raphidophyceae;Chattonellales;Chattonellaceae;Chattonella;Chattonella_marina;	Eukaryota;unknown;Raphidophyceae;Chattonellales;Chattonellaceae;Chattonella;Chattonella_marina;
Zotu188	Eukaryota;Gastrotricha;unknown;Chaetonotida;Chaetonotidae;Chaetonotus;	Eukaryota;Gastrotricha;unknown;Chaetonotida;Chaetonotidae;Chaetonotus;Chaetonotus_aff._persimilis_MK-2019;
Zotu189	Bacteria;Pseudomonadota;Alphaproteobacteria;Rickettsiales;Rickettsiaceae;Candidatus_Megaera;	Bacteria;Pseudomonadota;Alphaproteobacteria;Rickettsiales;Rickettsiaceae;Candidatus_Megaera;Candidatus_Megaira_endosymbiont_of_Mesostigma_viride;
Zotu190	Eukaryota;Rotifera;Eurotatoria;Ploima;	Eukaryota;Rotifera;Eurotatoria;Ploima;Gastropidae;Ascomorpha;Ascomorpha_ovalis;
Zotu191	Unknown	Eukaryota;Rotifera;Eurotatoria;Flosculariaceae;Conochilidae;Conochilus;Conochilus_unicornis;
Zotu192	Unknown	Eukaryota;Nematoda;Chromadorea;Rhabditida;Aphelenchoididae;Bursaphelenchus;Bursaphelenchus_cocophilus;
Zotu194	Eukaryota;unknown;	Eukaryota;unknown;Phaeophyceae;unknown;unknown;Bachelotia;Bachelotia_antillarum;
Zotu199	Eukaryota;Oomycota;unknown;Peronosporales;Peronosporaceae;Phytophthora;Phytophthora_ramorum;	Eukaryota;Streptophyta;Klebsormidiophyceae;Klebsormidiales;Klebsormidiaceae;Interfilum;Interfilum_terricola;
Zotu200	Unknown	Eukaryota;Rotifera;Eurotatoria;Flosculariaceae;Conochilidae;Conochilus;Conochilus_unicornis;
Zotu201	Eukaryota;Bacillariophyta;	Eukaryota;Bacillariophyta;Mediophyceae;Lithodesmiales;Lithodesmiaceae;Ditylum;Ditylum_brightwellii;
Zotu203	Eukaryota;unknown;	Eukaryota;unknown;Chrysophyceae;Chromulinales;Dinobryaceae;Poteriospumella;Poteriospumella_sp.;
Zotu204	Eukaryota;	Eukaryota;Chlorophyta;Trebouxiophyceae;Chlorellales;Chlorellaceae;Chlorella;Chlorella_desiccata_(nom._nud.);
Zotu205	Eukaryota;	Eukaryota;Chlorophyta;Trebouxiophyceae;Prasiolales;Koliellaceae;Koliella;Koliella_sp._HS-2024a;
Zotu206	Eukaryota;Rotifera;Eurotatoria;Ploima;Brachionidae;Keratella;Keratella_cochlearis;	Eukaryota;Rotifera;Eurotatoria;Ploima;Brachionidae;Keratella;Keratella_cochlearis;
Zotu209	Eukaryota;unknown;Chrysophyceae;Chromulinales;Dinobryaceae;Dinobryon;	Eukaryota;unknown;Chrysophyceae;Chromulinales;Dinobryaceae;Dinobryon;Dinobryon_cylindricollarium;
Zotu210	Eukaryota;unknown;Phaeophyceae;Ectocarpales;	Eukaryota;unknown;Phaeophyceae;Ectocarpales;Acinetosporaceae;unknown;Acinetosporaceae_sp._11_AP-2014;
Zotu211	Eukaryota;	Eukaryota;Chlorophyta;Trebouxiophyceae;unknown;Coccomyxaceae;Medakamo;Medakamo_hakoo;
Zotu212	Unknown	Eukaryota;Nematoda;Chromadorea;Rhabditida;Aphelenchoididae;Bursaphelenchus;Bursaphelenchus_cocophilus;
Zotu213	Unknown	Eukaryota;Arthropoda;Insecta;Hemiptera;Aphididae;Hyalomyzus;Hyalomyzus_sp._BIOUG21286-E01;
Zotu214	Bacteria;Pseudomonadota;Betaproteobacteria;Nitrosomonadales;Methylophilaceae;	Bacteria;Pseudomonadota;Betaproteobacteria;Nitrosomonadales;Methylophilaceae;Methylotenera;Methylotenera_versatilis;
Zotu215	Eukaryota;	Eukaryota;unknown;unknown;unknown;unknown;unknown;invertebrate_environmental_sample;
Zotu217	Eukaryota;Ascomycota;Leotiomycetes;	Eukaryota;Ascomycota;Leotiomycetes;Thelebolales;Thelebolaceae;Pseudogymnoascus;Pseudogymnoascus_destructans;
Zotu219	Eukaryota;Bacillariophyta;Bacillariophyceae;Naviculales;Sellaphoraceae;Sellaphora;	Eukaryota;Bacillariophyta;Bacillariophyceae;Naviculales;Sellaphoraceae;Sellaphora;Sellaphora_cf._seminulum;
Zotu220	Eukaryota;Chlorophyta;Chlorophyceae;Chlamydomonadales;unknown;Limnomonas;Limnomonas_gaiensis;	Eukaryota;Chlorophyta;Chlorophyceae;Chlamydomonadales;Chlamydomonadaceae;Chlamydomonas;Chlamydomonas_sp._UWO_241;
Zotu221	Eukaryota;Arthropoda;Insecta;Diptera;Chironomidae;	Eukaryota;Arthropoda;Insecta;Diptera;Chironomidae;Tanytarsus;Tanytarsus_sp._BARS_2016_26_085;
Zotu222	Eukaryota;unknown;Raphidophyceae;Chattonellales;Chattonellaceae;Chattonella;Chattonella_marina;	Eukaryota;unknown;Chrysophyceae;Chromulinales;Dinobryaceae;Dinobryon;Dinobryon_similis;
Zotu224	Bacteria;Pseudomonadota;Alphaproteobacteria;Rickettsiales;Rickettsiaceae;	Bacteria;Pseudomonadota;Alphaproteobacteria;Rickettsiales;Rickettsiaceae;Candidatus_Tisiphia;Candidatus_Tisiphia_endosymbiont_of_Thecophora_atra;
Zotu226	Eukaryota;Rotifera;Eurotatoria;Ploima;Brachionidae;Keratella;Keratella_cochlearis;	Eukaryota;Rotifera;Eurotatoria;Ploima;Brachionidae;Keratella;Keratella_cochlearis;
Zotu227	Eukaryota;Rotifera;Eurotatoria;Ploima;Synchaetidae;Synchaeta;	Eukaryota;Rotifera;Eurotatoria;Ploima;Synchaetidae;Synchaeta;Synchaeta_lakowitziana;
Zotu229	Unknown	Eukaryota;Mollusca;Bivalvia;Galeommatida;Montacutidae;Kurtiella;Kurtiella_bidentata;
Zotu231	Eukaryota;Rotifera;Eurotatoria;Ploima;	Eukaryota;Rotifera;Eurotatoria;Ploima;Trichocercidae;Trichocerca;Trichocerca_sp._WM-2017d;
Zotu232	Bacteria;Pseudomonadota;Alphaproteobacteria;Rickettsiales;Rickettsiaceae;Candidatus_Megaera;	Bacteria;Pseudomonadota;Alphaproteobacteria;Rickettsiales;Rickettsiaceae;Candidatus_Megaera;Candidatus_Megaera_polyxenophila;
Zotu233	Eukaryota;Oomycota;unknown;Peronosporales;Peronosporaceae;Phytophthora;Phytophthora_ramorum;	Eukaryota;Streptophyta;Klebsormidiophyceae;Klebsormidiales;Klebsormidiaceae;Interfilum;Interfilum_terricola;
Zotu234	Unknown	Eukaryota;Rotifera;Eurotatoria;Ploima;Lecanidae;Lecane;Lecane_closterocerca;
Zotu235	Bacteria;Pseudomonadota;Alphaproteobacteria;Rickettsiales;Rickettsiaceae;	Bacteria;Pseudomonadota;Alphaproteobacteria;Rickettsiales;Rickettsiaceae;Candidatus_Tisiphia;Candidatus_Tisiphia_endosymbiont_of_Temnostethus_pusillus;
Zotu236	Eukaryota;unknown;Phaeophyceae;Ectocarpales;	Eukaryota;unknown;Chrysophyceae;Chromulinales;Chromulinaceae;Pedospumella;Pedospumella_sp._JBM19;
Zotu237	Eukaryota;Rotifera;Eurotatoria;Ploima;Synchaetidae;Polyarthra;	Eukaryota;Rotifera;Eurotatoria;Ploima;Synchaetidae;Polyarthra;Polyarthra_dolichoptera;
Zotu238	Eukaryota;Rotifera;Eurotatoria;Ploima;	Eukaryota;Rotifera;Eurotatoria;Ploima;Synchaetidae;Polyarthra;Polyarthra_sp._UO-2013;
Zotu240	Eukaryota;Rotifera;Eurotatoria;Ploima;	Eukaryota;Rotifera;Eurotatoria;Ploima;Trichocercidae;Trichocerca;Trichocerca_capucina;
Zotu242	Eukaryota;Chordata;Mammalia;Artiodactyla;Suidae;Sus;Sus_scrofa;	Eukaryota;Chordata;Mammalia;Artiodactyla;Suidae;Sus;Sus_scrofa;
Zotu244	Eukaryota;Rotifera;Eurotatoria;Ploima;	Eukaryota;Rotifera;Eurotatoria;Ploima;Lecanidae;Lecane;Lecane_sp._bulla5;
Zotu247	Eukaryota;Rotifera;Eurotatoria;Ploima;	Eukaryota;Rotifera;Eurotatoria;Ploima;Gastropidae;Ascomorpha;Ascomorpha_ovalis_AEG1;
Zotu248	Eukaryota;Chlorophyta;	Eukaryota;Chlorophyta;Trebouxiophyceae;unknown;unknown;Choricystis;Choricystis_sp._odSpoLacu1;
Zotu251	Eukaryota;Bacillariophyta;Coscinodiscophyceae;	Eukaryota;Bacillariophyta;Coscinodiscophyceae;Melosirales;Melosiraceae;Melosira;Melosira_ambiqua;
Zotu254	Eukaryota;Bacillariophyta;	Eukaryota;Bacillariophyta;Coscinodiscophyceae;Melosirales;Melosiraceae;Melosira;Melosira_ambiqua;
Zotu255	Eukaryota;Bacillariophyta;Coscinodiscophyceae;	Eukaryota;Bacillariophyta;Coscinodiscophyceae;Melosirales;Melosiraceae;Melosira;Melosira_ambiqua;
Zotu256	Eukaryota;unknown;	Eukaryota;unknown;Phaeophyceae;Scytothamnales;unknown;Stereocladon;Stereocladon_rugulosus;
Zotu257	Eukaryota;Chlorophyta;Chlorophyceae;Chlamydomonadales;unknown;Limnomonas;Limnomonas_gaiensis;	Eukaryota;Chlorophyta;Chlorophyceae;Chlamydomonadales;Chlamydomonadaceae;Chlamydomonas;Chlamydomonas_sp._UWO_241;
Zotu259	Eukaryota;Rotifera;	Eukaryota;Rotifera;Eurotatoria;Ploima;Gastropidae;Ascomorpha;Ascomorpha_ovalis_AEG1;
Zotu260	Eukaryota;unknown;	Eukaryota;unknown;Chrysophyceae;Chromulinales;Dinobryaceae;Dinobryon;Dinobryon_cylindricollarium;
Zotu261	Eukaryota;Chlorophyta;Chlorophyceae;Chlamydomonadales;	Eukaryota;Chlorophyta;Chlorophyceae;Chlamydomonadales;unknown;Limnomonas;Limnomonas_spitsbergensis;
Zotu262	Eukaryota;Gastrotricha;unknown;Chaetonotida;Chaetonotidae;Chaetonotus;	Eukaryota;Gastrotricha;unknown;Chaetonotida;Chaetonotidae;Chaetonotus;Chaetonotus_sp._2_MK-2019;
Zotu263	Eukaryota;Rotifera;Eurotatoria;Ploima;Synchaetidae;Synchaeta;	Eukaryota;Rotifera;Eurotatoria;Ploima;Synchaetidae;Synchaeta;Synchaeta_cf._tremula/oblonga_UO-2012;
Zotu264	Eukaryota;Bacillariophyta;	Eukaryota;Bacillariophyta;Bacillariophyceae;Naviculales;Amphipleuraceae;Frustulia;Frustulia_vulgaris;
Zotu265	Eukaryota;Rotifera;Eurotatoria;Ploima;Brachionidae;Keratella;Keratella_cochlearis;	Eukaryota;Rotifera;Eurotatoria;Ploima;Brachionidae;Keratella;Keratella_cochlearis;
Zotu266	Eukaryota;Rotifera;Eurotatoria;Ploima;Brachionidae;	Eukaryota;Rotifera;Eurotatoria;Ploima;Brachionidae;Keratella;Keratella_crassa;
Zotu267	Bacteria;Pseudomonadota;Alphaproteobacteria;Rickettsiales;Rickettsiaceae;Candidatus_Megaera;	Bacteria;Pseudomonadota;Alphaproteobacteria;Rickettsiales;Rickettsiaceae;Candidatus_Megaera;Candidatus_Megaera_polyxenophila;
Zotu268	Unknown	Eukaryota;Oomycota;unknown;Pythiales;Pythiaceae;Elongisporangium;Elongisporangium_helicandrum;
Zotu271	Eukaryota;Oomycota;unknown;Pythiales;Pythiaceae;	Eukaryota;Oomycota;unknown;Pythiales;Pythiaceae;Elongisporangium;Elongisporangium_undulatum;
Zotu272	Eukaryota;Rotifera;Eurotatoria;Ploima;	Eukaryota;Rotifera;Eurotatoria;Ploima;Synchaetidae;Polyarthra;Polyarthra_vulgaris;
Zotu276	Eukaryota;Arthropoda;Branchiopoda;Diplostraca;Daphniidae;Daphnia;	Eukaryota;Arthropoda;Branchiopoda;Diplostraca;Daphniidae;Daphnia;Daphnia_dubia;
Zotu277	Eukaryota;unknown;	Eukaryota;unknown;Chrysophyceae;unknown;unknown;unknown;Chrysophyceae_sp.;
Zotu278	Eukaryota;unknown;Phaeophyceae;Ectocarpales;	Eukaryota;unknown;Phaeophyceae;Ectocarpales;Chordariaceae;Mesogloia;Mesogloia_japonica;
Zotu279	Eukaryota;Chlorophyta;	Eukaryota;Chlorophyta;Trebouxiophyceae;unknown;Coccomyxaceae;Medakamo;Medakamo_hakoo;
Zotu281	Eukaryota;unknown;Phaeophyceae;Ectocarpales;Chordariaceae;	Eukaryota;unknown;Phaeophyceae;Ectocarpales;Chordariaceae;Myriotrichia;Myriotrichia_sp._1Norway;
Zotu282	Eukaryota;Chlorophyta;	Eukaryota;Chlorophyta;Trebouxiophyceae;Prasiolales;Koliellaceae;Koliella;Koliella_sp._HS-2024a;
Zotu284	Eukaryota;unknown;	Eukaryota;unknown;Chrysophyceae;Chromulinales;Chromulinaceae;Pedospumella;Pedospumella_sinomuralis;
Zotu285	Eukaryota;Arthropoda;	Eukaryota;Discosea;unknown;Himatismenida;unknown;Parvamoeba;Parvamoeba_rugata;
Zotu286	Bacteria;Pseudomonadota;Alphaproteobacteria;Hyphomicrobiales;Phyllobacteriaceae;	Bacteria;Pseudomonadota;Alphaproteobacteria;Hyphomicrobiales;Phyllobacteriaceae;Phyllobacterium;Phyllobacterium_sp._T1293;
Zotu287	Eukaryota;Bacillariophyta;	Eukaryota;Bacillariophyta;Fragilariophyceae;Fragilariales;Fragilariaceae;Asterionellopsis;Asterionellopsis_guyunusae;
Zotu288	Eukaryota;unknown;Phaeophyceae;Laminariales;Laminariaceae;Saccharina;Saccharina_sessilis;	Eukaryota;unknown;Phaeophyceae;Laminariales;Laminariaceae;Saccharina;Saccharina_sessilis;
Zotu290	Eukaryota;Rotifera;Eurotatoria;Ploima;	Eukaryota;Rotifera;Eurotatoria;Ploima;Trichocercidae;Trichocerca;Trichocerca_sp._WM-2017b;
Zotu291	Eukaryota;unknown;Chrysophyceae;Chromulinales;	Eukaryota;unknown;Synurophyceae;Ochromonadales;Ochromonadaceae;Poterioochromonas;Poterioochromonas_stipitata;
Zotu293	Eukaryota;	Eukaryota;Chlorophyta;Trebouxiophyceae;Prasiolales;Koliellaceae;Koliella;Koliella_sp._HS-2024a;
Zotu294	Eukaryota;unknown;	Eukaryota;unknown;Chrysophyceae;Chromulinales;Chromulinaceae;Pedospumella;Pedospumella_sinomuralis;
Zotu296	Eukaryota;unknown;	Eukaryota;unknown;Chrysophyceae;Chromulinales;Dinobryaceae;Dinobryon;Dinobryon_inclinatum;
Zotu297	Eukaryota;unknown;	Eukaryota;unknown;Phaeophyceae;Ectocarpales;Chordariaceae;unknown;Chordariaceae_sp._14_AP-2014;
Zotu298	Eukaryota;Arthropoda;Insecta;Diptera;Chironomidae;	Eukaryota;Arthropoda;Insecta;Diptera;Chironomidae;Tanytarsus;Tanytarsus_sp._BBDIQ185-10;
Zotu299	Eukaryota;Rotifera;Eurotatoria;Ploima;	Eukaryota;Rotifera;Eurotatoria;Ploima;Asplanchnidae;Asplanchna;Asplanchna_sp.;
Zotu300	Eukaryota;unknown;	Eukaryota;unknown;Chrysophyceae;Chromulinales;Chromulinaceae;Pedospumella;Pedospumella_sp._JBM19;
Zotu301	Eukaryota;unknown;	Eukaryota;unknown;Chrysophyceae;Chromulinales;Chromulinaceae;Pedospumella;Pedospumella_sinomuralis;
Zotu302	Eukaryota;Rotifera;Eurotatoria;Ploima;	Eukaryota;Rotifera;Eurotatoria;Ploima;Lecanidae;Lecane;Lecane_leontina;
Zotu303	Eukaryota;unknown;	Eukaryota;unknown;Chrysophyceae;Chromulinales;Dinobryaceae;Dinobryon;Dinobryon_exstoundulatum;
Zotu304	Eukaryota;	Eukaryota;unknown;unknown;unknown;unknown;Chrysoparadoxa;Chrysoparadoxa_australica;
Zotu306	Eukaryota;unknown;Dinophyceae;	Eukaryota;unknown;Dinophyceae;unknown;unknown;unknown;uncultured_dinoflagellate;
Zotu308	Eukaryota;unknown;Chrysophyceae;Chromulinales;	Eukaryota;unknown;Synurophyceae;Ochromonadales;Ochromonadaceae;Poterioochromonas;Poterioochromonas_stipitata;
Zotu309	Eukaryota;	Eukaryota;Chlorophyta;Trebouxiophyceae;Prasiolales;Koliellaceae;Koliella;Koliella_sp._HS-2024a;
Zotu311	Eukaryota;Chordata;Aves;Galliformes;Phasianidae;Gallus;Gallus_gallus;	Eukaryota;Chordata;Aves;Galliformes;Phasianidae;Gallus;Gallus_gallus;
Zotu312	Eukaryota;unknown;	Eukaryota;unknown;Chrysophyceae;Chromulinales;Chromulinaceae;Pedospumella;Pedospumella_sinomuralis;
Zotu313	Eukaryota;Rotifera;Eurotatoria;Ploima;	Eukaryota;Rotifera;Eurotatoria;Ploima;Asplanchnidae;Asplanchna;Asplanchna_sp.;
Zotu314	Unknown	Bacteria;Pseudomonadota;Alphaproteobacteria;Rickettsiales;Anaplasmataceae;Candidatus_Mesenet;Candidatus_Mesenet_endosymbiont_of_Agriotes_lineatus;
Zotu315	Eukaryota;Rhodophyta;Florideophyceae;	Eukaryota;unknown;Phaeophyceae;Ectocarpales;Chordariaceae;unknown;Chordariaceae_sp._7_AP-2014;
Zotu317	Eukaryota;	Eukaryota;unknown;Chrysophyceae;Chromulinales;Chromulinaceae;Pedospumella;Pedospumella_sinomuralis;
Zotu318	Bacteria;Pseudomonadota;Betaproteobacteria;Nitrosomonadales;Methylophilaceae;	Bacteria;Pseudomonadota;Betaproteobacteria;Nitrosomonadales;Methylophilaceae;Methylotenera;Methylotenera_sp.;
Zotu320	Eukaryota;Chytridiomycota;Chytridiomycetes;Synchytriales;Synchytriaceae;Synchytrium;Synchytrium_endobioticum;	Eukaryota;Chytridiomycota;Chytridiomycetes;Synchytriales;Synchytriaceae;Synchytrium;Synchytrium_microbalum;
Zotu321	Eukaryota;unknown;	Eukaryota;unknown;Chrysophyceae;Chromulinales;Dinobryaceae;Dinobryon;Dinobryon_similis;
Zotu322	Eukaryota;unknown;	Eukaryota;unknown;Chrysophyceae;Chromulinales;Chromulinaceae;Pedospumella;Pedospumella_sinomuralis;
Zotu323	Eukaryota;unknown;	Eukaryota;unknown;Chrysophyceae;Chromulinales;Dinobryaceae;Dinobryon;Dinobryon_exstoundulatum;
Zotu326	Eukaryota;unknown;	Eukaryota;unknown;Chrysophyceae;Chromulinales;Dinobryaceae;Dinobryon;Dinobryon_cylindricollarium;
Zotu327	Eukaryota;unknown;	Eukaryota;unknown;Chrysophyceae;Chromulinales;Chromulinaceae;Pedospumella;Pedospumella_sp.;
Zotu328	Eukaryota;Rotifera;	Eukaryota;Rotifera;Eurotatoria;Ploima;Gastropidae;Ascomorpha;Ascomorpha_ovalis_AEG1;
Zotu332	Eukaryota;	Eukaryota;unknown;unknown;unknown;unknown;unknown;Stramenopiles_sp.;
Zotu333	Eukaryota;Bacillariophyta;Bacillariophyceae;Naviculales;Sellaphoraceae;Sellaphora;	Eukaryota;Bacillariophyta;Bacillariophyceae;Naviculales;Sellaphoraceae;Sellaphora;Sellaphora_cf._seminulum;
Zotu335	Unknown	Eukaryota;Chytridiomycota;Monoblepharidomycetes;Monoblepharidales;unknown;Hyaloraphidium;Hyaloraphidium_curvatum;
Zotu336	Eukaryota;Rotifera;Eurotatoria;Ploima;	Eukaryota;Rotifera;Eurotatoria;Ploima;Synchaetidae;Synchaeta;Synchaeta_tremula;
Zotu337	Eukaryota;Chlorophyta;Chlorophyceae;Chlamydomonadales;unknown;Limnomonas;Limnomonas_gaiensis;	Eukaryota;Chlorophyta;Chlorophyceae;Chlamydomonadales;Chlamydomonadaceae;Chlamydomonas;Chlamydomonas_sp._UWO_241;
Zotu338	Eukaryota;	Eukaryota;Chlorophyta;Trebouxiophyceae;unknown;Coccomyxaceae;Medakamo;Medakamo_hakoo;
Zotu339	Eukaryota;unknown;	Eukaryota;unknown;Chrysophyceae;Chromulinales;Chromulinaceae;Pedospumella;Pedospumella_sinomuralis;
Zotu341	Eukaryota;unknown;	Eukaryota;unknown;Phaeophyceae;Laminariales;Laminariaceae;Saccharina;Saccharina_sessilis;
Zotu344	Eukaryota;Rotifera;Eurotatoria;Ploima;	Eukaryota;Rotifera;Eurotatoria;Ploima;Lecanidae;Lecane;Lecane_leontina;
Zotu345	Eukaryota;unknown;	Eukaryota;unknown;Chrysophyceae;Chromulinales;Chromulinaceae;Pedospumella;Pedospumella_sinomuralis;
Zotu346	Eukaryota;Oomycota;unknown;Peronosporales;Peronosporaceae;Phytophthora;Phytophthora_ramorum;	Eukaryota;Streptophyta;Klebsormidiophyceae;Klebsormidiales;Klebsormidiaceae;Interfilum;Interfilum_terricola;
Zotu347	Eukaryota;unknown;Phaeophyceae;Ectocarpales;	Eukaryota;unknown;Chrysophyceae;Chromulinales;Dinobryaceae;Dinobryon;Dinobryon_similis;
Zotu349	Eukaryota;Rotifera;Eurotatoria;Ploima;Brachionidae;Keratella;Keratella_cochlearis;	Eukaryota;Rotifera;Eurotatoria;Ploima;Brachionidae;Keratella;Keratella_cochlearis;
Zotu351	Eukaryota;Oomycota;unknown;Peronosporales;Peronosporaceae;Phytophthora;Phytophthora_ramorum;	Eukaryota;Streptophyta;Klebsormidiophyceae;Klebsormidiales;Klebsormidiaceae;Interfilum;Interfilum_terricola;
Zotu354	Eukaryota;Gastrotricha;unknown;Chaetonotida;Chaetonotidae;	Eukaryota;Gastrotricha;unknown;Chaetonotida;Chaetonotidae;Heterolepidoderma;Heterolepidoderma_sp._2_TK-2012;
Zotu357	Eukaryota;	Eukaryota;Streptophyta;Klebsormidiophyceae;Klebsormidiales;Klebsormidiaceae;Interfilum;Interfilum_terricola;
Zotu358	Eukaryota;unknown;Phaeophyceae;Ectocarpales;Scytosiphonaceae;Petalonia;Petalonia_fascia;	Eukaryota;unknown;Eustigmatophyceae;Goniochloridales;Goniochloridaceae;Trachydiscus;Trachydiscus_minutus;
Zotu359	Eukaryota;	Eukaryota;Tubulinea;Elardia;Arcellinida;Netzeliidae;Cucurbitella;Cucurbitella_mespiliformis;
Zotu360	Eukaryota;Rotifera;Eurotatoria;Ploima;	Eukaryota;Rotifera;Eurotatoria;Ploima;Lecanidae;Lecane;Lecane_leontina;
Zotu363	Eukaryota;unknown;Chrysophyceae;Chromulinales;Dinobryaceae;Dinobryon;	Eukaryota;unknown;Chrysophyceae;Chromulinales;Dinobryaceae;Dinobryon;Dinobryon_exstoundulatum;
Zotu364	Eukaryota;Rotifera;Eurotatoria;Ploima;Brachionidae;Keratella;Keratella_cochlearis;	Eukaryota;Rotifera;Eurotatoria;Ploima;Brachionidae;Keratella;Keratella_cochlearis;
Zotu367	Eukaryota;Rotifera;Eurotatoria;Ploima;	Eukaryota;Rotifera;Eurotatoria;Ploima;Synchaetidae;Ploesoma;Ploesoma_truncatum;
Zotu368	Eukaryota;unknown;Dinophyceae;	Eukaryota;unknown;Dinophyceae;unknown;unknown;unknown;uncultured_dinoflagellate;
Zotu369	Eukaryota;unknown;	Eukaryota;unknown;Chrysophyceae;Chromulinales;Dinobryaceae;Dinobryon;Dinobryon_cylindricollarium;
Zotu370	Eukaryota;Cnidaria;Hydrozoa;Leptothecata;Obeliidae;Obelia;	Eukaryota;Cnidaria;Hydrozoa;Leptothecata;Obeliidae;Obelia;Obelia_dichotoma;
Zotu372	Eukaryota;	Eukaryota;Basidiomycota;Malasseziomycetes;Malasseziales;Malasseziaceae;Malassezia;Malassezia_arunalokei;
Zotu375	Bacteria;Pseudomonadota;Alphaproteobacteria;Rickettsiales;Rickettsiaceae;Candidatus_Megaera;	Bacteria;Pseudomonadota;Alphaproteobacteria;Rickettsiales;Rickettsiaceae;Candidatus_Megaera;Candidatus_Megaira_endosymbiont_of_Mesostigma_viride;
Zotu381	Eukaryota;unknown;Dinophyceae;	Eukaryota;unknown;Dinophyceae;unknown;unknown;unknown;uncultured_dinoflagellate;
Zotu382	Eukaryota;unknown;	Eukaryota;unknown;Synurophyceae;Synurales;Mallomonadaceae;Synura;Synura_sp.;
Zotu383	Eukaryota;unknown;	Eukaryota;unknown;Chrysophyceae;Chromulinales;Dinobryaceae;Dinobryon;Dinobryon_similis;
Zotu386	Eukaryota;unknown;	Eukaryota;unknown;Chrysophyceae;unknown;unknown;unknown;Chrysophyceae_sp.;
Zotu387	Eukaryota;Bacillariophyta;Bacillariophyceae;Naviculales;Sellaphoraceae;Sellaphora;	Eukaryota;Bacillariophyta;Bacillariophyceae;Naviculales;Sellaphoraceae;Sellaphora;Sellaphora_cf._seminulum;
Zotu388	Unknown	Eukaryota;Rotifera;Eurotatoria;Flosculariaceae;Conochilidae;Conochilus;Conochilus_unicornis;
Zotu390	Bacteria;Pseudomonadota;Alphaproteobacteria;	Bacteria;Pseudomonadota;Alphaproteobacteria;Rhodospirillales;Azospirillaceae;Skermanella;Skermanella_pratensis;
Zotu392	Eukaryota;Bacillariophyta;Bacillariophyceae;Naviculales;Sellaphoraceae;Sellaphora;	Eukaryota;Bacillariophyta;Bacillariophyceae;Naviculales;Sellaphoraceae;Sellaphora;Sellaphora_cf._seminulum;
Zotu393	Eukaryota;unknown;Chrysophyceae;Chromulinales;Dinobryaceae;Dinobryon;Dinobryon_pediforme;	Eukaryota;unknown;Chrysophyceae;Chromulinales;Dinobryaceae;Dinobryon;Dinobryon_pediforme;
Zotu395	Eukaryota;unknown;Eustigmatophyceae;Eustigmatales;Monodopsidaceae;Nannochloropsis;	Eukaryota;unknown;Eustigmatophyceae;Eustigmatales;Monodopsidaceae;Nannochloropsis;Nannochloropsis_limnetica;
Zotu396	Eukaryota;Gastrotricha;unknown;Chaetonotida;Chaetonotidae;	Eukaryota;Gastrotricha;unknown;Chaetonotida;Chaetonotidae;Chaetonotus;Chaetonotus_aff._sphagnophilus_MK-2019;
Zotu398	Unknown	Eukaryota;Arthropoda;Insecta;Hemiptera;Aphididae;Hyalomyzus;Hyalomyzus_sp._BIOUG21286-E01;
Zotu399	Eukaryota;unknown;	Eukaryota;unknown;Chrysophyceae;Chromulinales;Dinobryaceae;Dinobryon;Dinobryon_balticum;
Zotu400	Eukaryota;Rotifera;Eurotatoria;Ploima;	Eukaryota;Rotifera;Eurotatoria;Ploima;Lecanidae;Lecane;Lecane_leontina;
Zotu402	Eukaryota;	Eukaryota;Chlorophyta;Mamiellophyceae;Monomastigales;Monomastigaceae;Monomastix;Monomastix_minuta;
Zotu403	Eukaryota;unknown;Dinophyceae;	Eukaryota;unknown;Dinophyceae;unknown;unknown;unknown;uncultured_dinoflagellate;
Zotu405	Eukaryota;unknown;	Eukaryota;unknown;Chrysophyceae;Chromulinales;Chromulinaceae;Pedospumella;Pedospumella_sp._JBM19;
Zotu406	Eukaryota;unknown;	Eukaryota;unknown;Phaeophyceae;Ectocarpales;Scytosiphonaceae;Colpomenia;Colpomenia_sinuosa;
Zotu410	Eukaryota;Bacillariophyta;Bacillariophyceae;Naviculales;Sellaphoraceae;Sellaphora;	Eukaryota;Bacillariophyta;Bacillariophyceae;Naviculales;Sellaphoraceae;Sellaphora;Sellaphora_cf._seminulum;
Zotu411	Eukaryota;Oomycota;unknown;Peronosporales;Peronosporaceae;Phytophthora;	Eukaryota;Oomycota;unknown;Saprolegniales;Saprolegniaceae;Achlya;Achlya_flagellata;
Zotu412	Eukaryota;	Eukaryota;Chlorophyta;Trebouxiophyceae;Chlorellales;Chlorellaceae;Marvania;Marvania_geminata;
Zotu413	Eukaryota;Rotifera;Eurotatoria;Ploima;Asplanchnidae;Asplanchna;	Eukaryota;Rotifera;Eurotatoria;Ploima;Asplanchnidae;Asplanchna;Asplanchna_sp._BIOUG30062-H10;
Zotu415	Eukaryota;	Eukaryota;unknown;unknown;unknown;unknown;unknown;invertebrate_environmental_sample;
Zotu416	Eukaryota;unknown;	Eukaryota;unknown;Synurophyceae;Synurales;Mallomonadaceae;Mallomonas;Mallomonas_sp.;
Zotu417	Eukaryota;unknown;	Eukaryota;unknown;Chrysophyceae;Chromulinales;Chromulinaceae;Pedospumella;Pedospumella_sp.;
Zotu418	Unknown	Bacteria;Pseudomonadota;Alphaproteobacteria;Rickettsiales;Rickettsiaceae;Rickettsia;Rickettsia_bellii;
Zotu420	Eukaryota;unknown;Phaeophyceae;Ectocarpales;	Eukaryota;unknown;Phaeophyceae;Ectocarpales;Chordariaceae;Myrionema;Myrionema_balticum;
Zotu421	Unknown	Eukaryota;Rotifera;Eurotatoria;Ploima;Brachionidae;Brachionus;Brachionus_plicatilis_complex_sp._USSAL033;
Zotu424	Eukaryota;Chlorophyta;Chlorophyceae;Sphaeropleales;Scenedesmaceae;	Eukaryota;Chlorophyta;Chlorophyceae;Sphaeropleales;Scenedesmaceae;Scenedesmus;Scenedesmus_quadricauda;
Zotu425	Eukaryota;Ascomycota;	Eukaryota;Ascomycota;Dothideomycetes;Mycosphaerellales;Mycosphaerellaceae;Cercospora;Cercospora_sojina;
Zotu427	Eukaryota;Rotifera;Eurotatoria;Ploima;Brachionidae;	Eukaryota;Rotifera;Eurotatoria;Ploima;Brachionidae;Keratella;Keratella_sp._STE97;
Zotu428	Eukaryota;Chlorophyta;Chlorophyceae;Chlamydomonadales;unknown;Limnomonas;Limnomonas_gaiensis;	Eukaryota;Chlorophyta;Chlorophyceae;Chlamydomonadales;unknown;Limnomonas;Limnomonas_spitsbergensis;
Zotu429	Eukaryota;Chlorophyta;Trebouxiophyceae;unknown;	Eukaryota;Chlorophyta;Trebouxiophyceae;unknown;unknown;Choricystis;Choricystis_sp._odSpoLacu1;
Zotu430	Eukaryota;unknown;Phaeophyceae;Ectocarpales;Ectocarpaceae;Ectocarpus;Ectocarpus_siliculosus;	Eukaryota;unknown;Phaeophyceae;Ectocarpales;Ectocarpaceae;Ectocarpus;Ectocarpus_siliculosus;
Zotu431	Eukaryota;unknown;	Eukaryota;unknown;Chrysophyceae;Chromulinales;Dinobryaceae;Dinobryon;Dinobryon_cylindricollarium;
Zotu432	Eukaryota;unknown;	Eukaryota;unknown;Chrysophyceae;Chromulinales;Dinobryaceae;Dinobryon;Dinobryon_taiyuanensis;
Zotu434	Eukaryota;unknown;	Eukaryota;unknown;unknown;unknown;unknown;unknown;Stramenopiles_sp.;
Zotu436	Eukaryota;Rotifera;Eurotatoria;Ploima;Synchaetidae;Synchaeta;	Eukaryota;Rotifera;Eurotatoria;Ploima;Synchaetidae;Synchaeta;Synchaeta_pectinata;
Zotu437	Eukaryota;Bacillariophyta;Coscinodiscophyceae;	Eukaryota;Bacillariophyta;Coscinodiscophyceae;Melosirales;Melosiraceae;Melosira;Melosira_ambiqua;
Zotu438	Eukaryota;	Eukaryota;unknown;Chrysophyceae;Chromulinales;Chromulinaceae;Pedospumella;Pedospumella_sinomuralis;
Zotu439	Eukaryota;unknown;Dinophyceae;	Eukaryota;unknown;Dinophyceae;unknown;unknown;unknown;uncultured_dinoflagellate;
Zotu440	Eukaryota;Discosea;unknown;Longamoebia;Acanthamoebidae;Acanthamoeba;	Eukaryota;Discosea;unknown;Longamoebia;Acanthamoebidae;Acanthamoeba;Acanthamoeba_sp.;
Zotu441	Eukaryota;Rotifera;Eurotatoria;Ploima;	Eukaryota;Rotifera;Eurotatoria;Ploima;Trichocercidae;Trichocerca;Trichocerca_sp._WM-2017h;
Zotu443	Eukaryota;Oomycota;unknown;Peronosporales;Peronosporaceae;	Eukaryota;Oomycota;unknown;Peronosporales;Peronosporaceae;Nothophytophthora;Nothophytophthora_caduca;
Zotu444	Eukaryota;Oomycota;unknown;	Eukaryota;Oomycota;unknown;Saprolegniales;Saprolegniaceae;Saprolegnia;Saprolegnia_turfosa;
Zotu445	Eukaryota;	Eukaryota;unknown;Choanoflagellata;Craspedida;Salpingoecidae;Monosiga;Monosiga_brevicollis;
Zotu446	Eukaryota;unknown;Bigyra;Thraustochytrida;Thraustochytriaceae;	Eukaryota;unknown;Bigyra;Thraustochytrida;Thraustochytriaceae;Schizochytrium;Schizochytrium_sp._SEK_210;
Zotu448	Eukaryota;Oomycota;unknown;Peronosporales;Peronosporaceae;Phytophthora;	Eukaryota;Oomycota;unknown;Peronosporales;Peronosporaceae;Phytophthora;Phytophthora_bishii;
Zotu453	Eukaryota;Rotifera;Eurotatoria;Ploima;	Eukaryota;Rotifera;Eurotatoria;Ploima;Asplanchnidae;Asplanchna;Asplanchna_cf._sieboldi_MEG-2012;
Zotu454	Eukaryota;Mucoromycota;Mucoromycetes;Mucorales;	Eukaryota;Mucoromycota;Mucoromycetes;Mucorales;Mucoraceae;Mucor;Mucor_piriformis;
Zotu455	Bacteria;Pseudomonadota;Alphaproteobacteria;	Bacteria;Pseudomonadota;Alphaproteobacteria;Rhodospirillales;Rhodospirillaceae;Magnetospirillum;Magnetospirillum_sp._XM-1;
Zotu456	Eukaryota;unknown;	Eukaryota;unknown;Chrysophyceae;Chromulinales;Dinobryaceae;Dinobryon;Dinobryon_cylindricollarium;
Zotu457	Eukaryota;	Eukaryota;unknown;unknown;unknown;unknown;unknown;Stramenopiles_sp.;
Zotu458	Eukaryota;Rotifera;Eurotatoria;Ploima;Synchaetidae;Polyarthra;Polyarthra_dolichoptera_complex_sp._UO-2013;	Eukaryota;Rotifera;Eurotatoria;Ploima;Synchaetidae;Polyarthra;Polyarthra_dolichoptera_complex_sp._UO-2013;
Zotu459	Eukaryota;unknown;	Eukaryota;unknown;Chrysophyceae;Chromulinales;Chromulinaceae;Pedospumella;Pedospumella_sinomuralis;
Zotu460	Eukaryota;unknown;Dinophyceae;	Eukaryota;unknown;Dinophyceae;Thoracosphaerales;Thoracosphaeraceae;Thoracosphaera;Thoracosphaera_heimii;
Zotu461	Eukaryota;unknown;Dinophyceae;	Eukaryota;unknown;Dinophyceae;unknown;unknown;unknown;uncultured_dinoflagellate;
Zotu464	Eukaryota;unknown;Raphidophyceae;Chattonellales;Chattonellaceae;Chattonella;Chattonella_marina;	Eukaryota;unknown;Chrysophyceae;Chromulinales;Dinobryaceae;Dinobryon;Dinobryon_similis;
Zotu467	Eukaryota;Chlorophyta;Trebouxiophyceae;unknown;	Eukaryota;Chlorophyta;Trebouxiophyceae;unknown;unknown;Choricystis;Choricystis_parasitica;
Zotu470	Eukaryota;	Eukaryota;Chlorophyta;Trebouxiophyceae;Prasiolales;Koliellaceae;Koliella;Koliella_sp._HS-2024a;
Zotu472	Eukaryota;Arthropoda;Insecta;Lepidoptera;	Eukaryota;Rotifera;Eurotatoria;Flosculariaceae;Conochilidae;Conochilus;Conochilus_unicornis;
Zotu474	Eukaryota;unknown;Chrysophyceae;Chromulinales;Dinobryaceae;Dinobryon;Dinobryon_pediforme;	Eukaryota;unknown;Chrysophyceae;Chromulinales;Dinobryaceae;Dinobryon;Dinobryon_pediforme;
Zotu475	Eukaryota;Gastrotricha;unknown;Chaetonotida;Chaetonotidae;Chaetonotus;	Eukaryota;Gastrotricha;unknown;Chaetonotida;Chaetonotidae;Chaetonotus;Chaetonotus_sp._2_MK-2019;
Zotu477	Eukaryota;unknown;	Eukaryota;unknown;Chrysophyceae;Chromulinales;Dinobryaceae;Dinobryon;Dinobryon_cylindricollarium;
Zotu482	Unknown	Eukaryota;Gastrotricha;unknown;Chaetonotida;Chaetonotidae;Chaetonotus;Chaetonotus_sp._1_TK-2012;
Zotu483	Eukaryota;Arthropoda;Insecta;Diptera;Chironomidae;Tanytarsus;	Eukaryota;Arthropoda;Insecta;Diptera;Chironomidae;Tanytarsus;Tanytarsus_sp._BOLD-2016;
Zotu484	Eukaryota;Bacillariophyta;	Eukaryota;Mollusca;Gastropoda;unknown;Pachychilidae;Sulcospira;Sulcospira_paludiformis;
Zotu485	Eukaryota;unknown;Chrysophyceae;Chromulinales;Dinobryaceae;Dinobryon;	Eukaryota;unknown;Chrysophyceae;Chromulinales;Dinobryaceae;Dinobryon;Dinobryon_cylindricum;
Zotu486	Eukaryota;Streptophyta;	Eukaryota;Streptophyta;Zygnemophyceae;Zygnematales;Mesotaeniaceae;Cylindrocystis;Cylindrocystis_brebissonii;
Zotu490	Eukaryota;Arthropoda;Insecta;Diptera;Mycetophilidae;unknown;Mycetophilidae_sp.;	Eukaryota;Arthropoda;Insecta;Diptera;Mycetophilidae;unknown;Mycetophilidae_sp.;
Zotu491	Eukaryota;	Eukaryota;Chlorophyta;Trebouxiophyceae;Chlorellales;Chlorellaceae;Marvania;Marvania_geminata;
Zotu493	Bacteria;Pseudomonadota;Alphaproteobacteria;Rickettsiales;Rickettsiaceae;Candidatus_Megaera;	Bacteria;Pseudomonadota;Alphaproteobacteria;Rickettsiales;Rickettsiaceae;Candidatus_Megaera;Candidatus_Megaera_polyxenophila;
Zotu494	Unknown	Eukaryota;Oomycota;unknown;unknown;unknown;Haptoglossa;Haptoglossa_sp._DM2_4/12;
Zotu495	Unknown	Eukaryota;Discosea;Flabellinia;unknown;Vannellidae;Ripella;Ripella_tribonemae;
Zotu496	Eukaryota;	Eukaryota;unknown;Chrysophyceae;Chromulinales;Dinobryaceae;Dinobryon;Dinobryon_sertularia;
Zotu497	Eukaryota;	Eukaryota;Bacillariophyta;Coscinodiscophyceae;Coscinodiscales;Coscinodiscaceae;Coscinodiscus;Coscinodiscus_wailesii;
Zotu499	Eukaryota;unknown;	Eukaryota;unknown;Phaeophyceae;Ectocarpales;Scytosiphonaceae;Colpomenia;Colpomenia_sinuosa;
Zotu500	Eukaryota;unknown;	Eukaryota;unknown;Chrysophyceae;Chromulinales;Dinobryaceae;Dinobryon;Dinobryon_similis;
Zotu501	Eukaryota;Ascomycota;Sordariomycetes;	Eukaryota;Ascomycota;Sordariomycetes;Hypocreales;Stachybotryaceae;Myrothecium;Myrothecium_inundatum;
Zotu502	Eukaryota;Bacillariophyta;Bacillariophyceae;Naviculales;Sellaphoraceae;Sellaphora;	Eukaryota;Bacillariophyta;Bacillariophyceae;Naviculales;Sellaphoraceae;Sellaphora;Sellaphora_cf._seminulum;
Zotu503	Eukaryota;Rotifera;Eurotatoria;Ploima;	Eukaryota;Rotifera;Eurotatoria;Ploima;Trichocercidae;Trichocerca;Trichocerca_stylata;
Zotu506	Unknown	Eukaryota;unknown;Phaeophyceae;Ectocarpales;Acinetosporaceae;unknown;Acinetosporaceae_sp._14_AP-2014;
Zotu507	Eukaryota;Oomycota;unknown;	Eukaryota;unknown;unknown;unknown;unknown;unknown;Amoebozoa_sp.;
Zotu508	Eukaryota;Bacillariophyta;Coscinodiscophyceae;	Eukaryota;Bacillariophyta;Coscinodiscophyceae;Melosirales;Melosiraceae;Melosira;Melosira_ambiqua;
Zotu510	Eukaryota;unknown;Raphidophyceae;Chattonellales;Chattonellaceae;Chattonella;Chattonella_marina;	Eukaryota;unknown;Xanthophyceae;Mischococcales;Mischococcaceae;Mischococcus;Mischococcus_sphaerocephalus;
Zotu511	Eukaryota;Chlorophyta;Chlorophyceae;Chlamydomonadales;unknown;Limnomonas;Limnomonas_gaiensis;	Eukaryota;Chlorophyta;Chlorophyceae;Chlamydomonadales;unknown;Limnomonas;Limnomonas_spitsbergensis;
Zotu512	Eukaryota;unknown;	Eukaryota;unknown;Synurophyceae;Synurales;Mallomonadaceae;Synura;Synura_sp.;
Zotu515	Eukaryota;unknown;	Eukaryota;unknown;Synurophyceae;Synurales;Mallomonadaceae;Synura;Synura_sp.;
Zotu516	Eukaryota;Bacillariophyta;Bacillariophyceae;Naviculales;Sellaphoraceae;Sellaphora;	Eukaryota;Bacillariophyta;Bacillariophyceae;Naviculales;Sellaphoraceae;Sellaphora;Sellaphora_cf._seminulum;
Zotu517	Eukaryota;unknown;	Eukaryota;unknown;Chrysophyceae;Chromulinales;Chromulinaceae;Pedospumella;Pedospumella_sp.;
Zotu518	Eukaryota;unknown;	Eukaryota;unknown;Synurophyceae;Synurales;Mallomonadaceae;Mallomonas;Mallomonas_sp.;
Zotu521	Eukaryota;Annelida;Clitellata;Tubificida;Naididae;	Eukaryota;Annelida;Clitellata;Tubificida;Naididae;Ilyodrilus;Ilyodrilus_templetoni;
Zotu522	Eukaryota;Gastrotricha;unknown;Chaetonotida;Chaetonotidae;Chaetonotus;	Eukaryota;Gastrotricha;unknown;Chaetonotida;Chaetonotidae;Chaetonotus;Chaetonotus_borealis;
Zotu523	Eukaryota;unknown;	Eukaryota;unknown;Synurophyceae;Synurales;Mallomonadaceae;Mallomonas;Mallomonas_sp.;
Zotu527	Unknown	Eukaryota;Discosea;unknown;Longamoebia;Acanthamoebidae;Acanthamoeba;Acanthamoeba_comandoni;
Zotu528	Eukaryota;unknown;	Eukaryota;unknown;Chrysophyceae;Chromulinales;Chromulinaceae;Pedospumella;Pedospumella_sinomuralis;
Zotu529	Eukaryota;unknown;	Eukaryota;unknown;Chrysophyceae;Chromulinales;Chromulinaceae;Pedospumella;Pedospumella_sp._JBM19;
Zotu530	Eukaryota;unknown;Dinophyceae;Peridiniales;Ostreopsidaceae;Ostreopsis;	Eukaryota;unknown;Dinophyceae;unknown;unknown;unknown;uncultured_dinoflagellate;
Zotu531	Unknown	Eukaryota;Arthropoda;Arachnida;unknown;unknown;unknown;Arachnida_sp._BOLD:ACI7857;
Zotu532	Eukaryota;Rotifera;Eurotatoria;Ploima;Brachionidae;Keratella;Keratella_cochlearis;	Eukaryota;Rotifera;Eurotatoria;Ploima;Brachionidae;Keratella;Keratella_cochlearis;
Zotu533	Eukaryota;unknown;Phaeophyceae;Ectocarpales;Scytosiphonaceae;Petalonia;Petalonia_fascia;	Eukaryota;unknown;Phaeophyceae;Ectocarpales;Scytosiphonaceae;Petalonia;Petalonia_fascia;
Zotu535	Eukaryota;unknown;	Eukaryota;unknown;Synurophyceae;Ochromonadales;Ochromonadaceae;Poterioochromonas;Poterioochromonas_stipitata;
Zotu537	Eukaryota;Cnidaria;Hydrozoa;Leptothecata;Obeliidae;Obelia;	Eukaryota;Cnidaria;Hydrozoa;Leptothecata;Obeliidae;Obelia;Obelia_dichotoma;
Zotu540	Unknown	Eukaryota;Discosea;Flabellinia;Dactylopodida;Vexilliferidae;Vexillifera;Vexillifera_kereti;
Zotu542	Eukaryota;	Eukaryota;unknown;Synurophyceae;Ochromonadales;Ochromonadaceae;Cornospumella;Cornospumella_fuschlensis;
Zotu544	Eukaryota;unknown;Dinophyceae;	Eukaryota;unknown;Dinophyceae;Peridiniales;Pfiesteriaceae;unknown;Pfiesteriaceae_sp._CCMP2836;
Zotu546	Eukaryota;unknown;Phaeophyceae;	Eukaryota;unknown;Chrysophyceae;Chromulinales;Dinobryaceae;Dinobryon;Dinobryon_balticum;
Zotu547	Unknown	Eukaryota;Rotifera;Eurotatoria;Ploima;Brachionidae;Brachionus;Brachionus_plicatilis_complex_sp._USSAL033;
Zotu548	Eukaryota;	Eukaryota;unknown;Raphidophyceae;unknown;unknown;Haramonas;Haramonas_dimorpha;
Zotu549	Eukaryota;unknown;	Eukaryota;unknown;Eustigmatophyceae;Eustigmatales;Monodopsidaceae;Nannochloropsis;Nannochloropsis_limnetica;
Zotu550	Unknown	Eukaryota;Arthropoda;Arachnida;Araneae;Idiopidae;Idiosoma;Idiosoma_sigillatum;
Zotu551	Eukaryota;unknown;Chrysophyceae;Chromulinales;Dinobryaceae;Dinobryon;	Eukaryota;unknown;Chrysophyceae;Chromulinales;Dinobryaceae;Dinobryon;Dinobryon_sertularia;
Zotu553	Eukaryota;unknown;	Eukaryota;unknown;Chrysophyceae;Chromulinales;Chromulinaceae;Pedospumella;Pedospumella_sp._JBM19;
Zotu554	Eukaryota;unknown;Phaeophyceae;Ectocarpales;	Eukaryota;unknown;Phaeophyceae;Ectocarpales;Acinetosporaceae;unknown;Acinetosporaceae_sp._3_AP-2014;
Zotu557	Unknown	Eukaryota;Chlorophyta;Chlorophyceae;Sphaeropleales;Scenedesmaceae;Scenedesmus;Scenedesmus_quadricauda;
Zotu558	Eukaryota;Oomycota;unknown;Peronosporales;Peronosporaceae;Phytophthora;	Eukaryota;Oomycota;unknown;Saprolegniales;Saprolegniaceae;Achlya;Achlya_sparrowii;
Zotu560	Eukaryota;unknown;	Eukaryota;unknown;Chrysophyceae;Chromulinales;Dinobryaceae;Dinobryon;Dinobryon_cylindricollarium;
Zotu561	Eukaryota;unknown;Dinophyceae;Peridiniales;Ostreopsidaceae;Ostreopsis;	Eukaryota;unknown;Dinophyceae;unknown;unknown;unknown;uncultured_dinoflagellate;
Zotu562	Eukaryota;Porifera;Demospongiae;Bubarida;Dictyonellidae;Scopalina;Scopalina_ruetzleri;	Eukaryota;Zoopagomycota;Entomophthoromycetes;Entomophthorales;Ancylistaceae;Conidiobolus;Conidiobolus_mycophagus;
Zotu563	Eukaryota;unknown;	Eukaryota;unknown;Chrysophyceae;unknown;unknown;unknown;Chrysophyceae_sp.;
Zotu564	Eukaryota;	Eukaryota;Oomycota;unknown;Peronosporales;Peronosporaceae;Phytophthora;Phytophthora_taxon_Sisuluriver;
Zotu565	Eukaryota;unknown;Phaeophyceae;Ectocarpales;Chordariaceae;	Eukaryota;unknown;Phaeophyceae;Ectocarpales;Chordariaceae;unknown;Chordariaceae_sp._7_AP-2014;
Zotu566	Eukaryota;Chytridiomycota;Chytridiomycetes;Synchytriales;Synchytriaceae;Synchytrium;Synchytrium_endobioticum;	Eukaryota;Chytridiomycota;Chytridiomycetes;Synchytriales;Synchytriaceae;Synchytrium;Synchytrium_microbalum;
Zotu567	Eukaryota;Rotifera;Eurotatoria;Ploima;Synchaetidae;Synchaeta;	Eukaryota;Rotifera;Eurotatoria;Ploima;Synchaetidae;Synchaeta;Synchaeta_gyrina;
Zotu568	Eukaryota;unknown;	Eukaryota;unknown;Eustigmatophyceae;Eustigmatales;Monodopsidaceae;Nannochloropsis;Nannochloropsis_limnetica;
Zotu569	Eukaryota;unknown;Raphidophyceae;Chattonellales;Chattonellaceae;Chattonella;Chattonella_marina;	Eukaryota;unknown;Raphidophyceae;Chattonellales;Chattonellaceae;Chattonella;Chattonella_marina;
Zotu570	Eukaryota;Rotifera;Eurotatoria;Ploima;Brachionidae;Keratella;Keratella_cochlearis;	Eukaryota;Rotifera;Eurotatoria;Ploima;Brachionidae;Keratella;Keratella_cochlearis;
Zotu571	Eukaryota;unknown;Dinophyceae;Peridiniales;Ostreopsidaceae;Ostreopsis;	Eukaryota;unknown;Dinophyceae;unknown;unknown;unknown;uncultured_dinoflagellate;
Zotu572	Eukaryota;Bacillariophyta;Coscinodiscophyceae;Stephanodiscales;Stephanodiscaceae;Discostella;	Eukaryota;Bacillariophyta;Coscinodiscophyceae;Stephanodiscales;Stephanodiscaceae;Discostella;Discostella_sp._clade_G_(type_IV);
Zotu574	Eukaryota;	Eukaryota;Tubulinea;Elardia;Arcellinida;Netzeliidae;Cucurbitella;Cucurbitella_mespiliformis;
Zotu575	Unknown	Eukaryota;unknown;Chrysophyceae;Chromulinales;Paraphysomonadaceae;Paraphysomonas;Paraphysomonas_sp.;
Zotu576	Eukaryota;unknown;	Eukaryota;unknown;Chrysophyceae;Chromulinales;Dinobryaceae;Dinobryon;Dinobryon_similis;
Zotu579	Eukaryota;	Eukaryota;Tubulinea;Elardia;Euamoebida;unknown;Copromyxa;Copromyxa_protea;
Zotu580	Eukaryota;Ascomycota;	Eukaryota;Ascomycota;Eurotiomycetes;Eurotiales;Aspergillaceae;Penicillium;Penicillium_digitatum;
Zotu582	Eukaryota;unknown;Dinophyceae;	Eukaryota;unknown;Dinophyceae;unknown;unknown;unknown;uncultured_dinoflagellate;
Zotu583	Eukaryota;Arthropoda;Hexanauplia;Calanoida;Diaptomidae;Leptodiaptomus;Leptodiaptomus_minutus;	Eukaryota;Arthropoda;Hexanauplia;Calanoida;Diaptomidae;Leptodiaptomus;Leptodiaptomus_minutus;
Zotu584	Eukaryota;Oomycota;unknown;Peronosporales;Peronosporaceae;Phytophthora;	Eukaryota;Oomycota;unknown;Peronosporales;Peronosporaceae;Phytophthora;Phytophthora_ohioensis_(nom._inval.);
Zotu586	Eukaryota;Bacillariophyta;Bacillariophyceae;Naviculales;Sellaphoraceae;Sellaphora;	Eukaryota;Bacillariophyta;Bacillariophyceae;Naviculales;Sellaphoraceae;Sellaphora;Sellaphora_cf._seminulum;
Zotu589	Eukaryota;Rotifera;Eurotatoria;Ploima;	Eukaryota;Rotifera;Eurotatoria;Ploima;Gastropidae;Ascomorpha;Ascomorpha_ovalis;
Zotu591	Eukaryota;Rotifera;Eurotatoria;	Eukaryota;Rotifera;Eurotatoria;unknown;unknown;Rotaria;Rotaria_macrura;
Zotu592	Unknown	Eukaryota;Rotifera;Eurotatoria;Ploima;Notommatidae;Cephalodella;Cephalodella_binoculata;
Zotu593	Eukaryota;Oomycota;unknown;Peronosporales;Peronosporaceae;Phytophthora;	Eukaryota;Oomycota;unknown;Peronosporales;Peronosporaceae;Phytophthora;Phytophthora_polonica;
Zotu595	Eukaryota;Rotifera;Eurotatoria;Ploima;	Eukaryota;Rotifera;Eurotatoria;Ploima;Asplanchnidae;Asplanchna;Asplanchna_cf._sieboldi_MEG-2012;
Zotu596	Eukaryota;unknown;Phaeophyceae;Ectocarpales;Chordariaceae;Dictyosiphon;Dictyosiphon_foeniculaceus;	Eukaryota;unknown;Chrysophyceae;Chromulinales;Dinobryaceae;Dinobryon;Dinobryon_cylindricollarium;
Zotu599	Eukaryota;unknown;	Eukaryota;unknown;Chrysophyceae;Chromulinales;Chromulinaceae;Pedospumella;Pedospumella_sinomuralis;
Zotu600	Eukaryota;unknown;Phaeophyceae;Ectocarpales;Chordariaceae;	Eukaryota;unknown;Phaeophyceae;Ectocarpales;Chordariaceae;unknown;Chordariaceae_sp._7_AP-2014;
Zotu602	Eukaryota;unknown;Chrysophyceae;Chromulinales;	Eukaryota;unknown;Chrysophyceae;Chromulinales;Chromulinaceae;Pedospumella;Pedospumella_sinomuralis;
Zotu603	Eukaryota;Bacillariophyta;Bacillariophyceae;Naviculales;Sellaphoraceae;Sellaphora;	Eukaryota;Bacillariophyta;Bacillariophyceae;Naviculales;Sellaphoraceae;Sellaphora;Sellaphora_cf._seminulum;
Zotu604	Eukaryota;unknown;Phaeophyceae;Ectocarpales;Scytosiphonaceae;Petalonia;Petalonia_fascia;	Eukaryota;unknown;Phaeophyceae;Ectocarpales;Scytosiphonaceae;Petalonia;Petalonia_fascia;
Zotu606	Eukaryota;unknown;	Eukaryota;unknown;Dictyochophyceae;Florenciellales;unknown;Florenciella;Florenciella_parvula;
Zotu608	Eukaryota;Discosea;	Eukaryota;Discosea;unknown;Longamoebia;Acanthamoebidae;Acanthamoeba;Acanthamoeba_comandoni;
Zotu610	Eukaryota;Ascomycota;Sordariomycetes;	Eukaryota;Ascomycota;Sordariomycetes;Ophiostomatales;Ophiostomataceae;Ophiostoma;Ophiostoma_piceae;
Zotu611	Eukaryota;Rotifera;Eurotatoria;Ploima;	Eukaryota;Rotifera;Eurotatoria;Ploima;Brachionidae;Brachionus;Brachionus_sp._WM-2017m;
Zotu612	Eukaryota;unknown;	Eukaryota;unknown;Chrysophyceae;Chromulinales;Dinobryaceae;Poteriospumella;Poteriospumella_lacustris;
Zotu613	Eukaryota;Bacillariophyta;	Eukaryota;Bacillariophyta;Mediophyceae;Lithodesmiales;Lithodesmiaceae;Lithodesmium;Lithodesmium_undulatum;
Zotu614	Eukaryota;	Eukaryota;unknown;Eustigmatophyceae;Eustigmatales;Monodopsidaceae;Nannochloropsis;Nannochloropsis_limnetica;
Zotu615	Eukaryota;Arthropoda;Insecta;Diptera;Chironomidae;unknown;	Eukaryota;Arthropoda;Insecta;Diptera;Chironomidae;Tanytarsus;Tanytarsus_sp._BBDEE262-10;
Zotu619	Eukaryota;	Eukaryota;Chlorophyta;Trebouxiophyceae;Chlorellales;Chlorellaceae;Chlorella;Chlorella_desiccata_(nom._nud.);
Zotu622	Eukaryota;unknown;Chrysophyceae;Chromulinales;	Eukaryota;unknown;Chrysophyceae;Chromulinales;Dinobryaceae;Dinobryon;Dinobryon_cylindricollarium;
Zotu624	Eukaryota;Chytridiomycota;Chytridiomycetes;Synchytriales;Synchytriaceae;Synchytrium;Synchytrium_endobioticum;	Eukaryota;Chytridiomycota;Chytridiomycetes;Synchytriales;Synchytriaceae;Synchytrium;Synchytrium_endobioticum;
Zotu626	Eukaryota;unknown;	Eukaryota;unknown;Synurophyceae;Ochromonadales;Ochromonadaceae;Poterioochromonas;Poterioochromonas_stipitata;
Zotu628	Eukaryota;	Eukaryota;unknown;Chrysophyceae;Chromulinales;Chromulinaceae;Pedospumella;Pedospumella_sinomuralis;
Zotu629	Eukaryota;	Eukaryota;Arthropoda;Protura;unknown;Fujientomidae;Fujientomon;Fujientomon_dicestum;
Zotu632	Eukaryota;unknown;	Eukaryota;unknown;Synurophyceae;Synurales;Mallomonadaceae;Synura;Synura_petersenii;
Zotu633	Eukaryota;Rotifera;Eurotatoria;Ploima;Brachionidae;	Eukaryota;Rotifera;Eurotatoria;Ploima;Brachionidae;Kellicottia;Kellicottia_bostoniensis;
Zotu634	Unknown	Eukaryota;unknown;unknown;unknown;unknown;unknown;zooplankton_environmental_sample;
Zotu637	Eukaryota;Oomycota;unknown;	Eukaryota;Oomycota;unknown;Peronosporales;Peronosporaceae;Phytophthora;Phytophthora_elongata;
Zotu638	Eukaryota;unknown;Phaeophyceae;Laminariales;Lessoniaceae;Ecklonia;Ecklonia_radiata;	Eukaryota;unknown;Phaeophyceae;Laminariales;Lessoniaceae;Eisenia;Eisenia_nipponica;
Zotu639	Eukaryota;unknown;	Eukaryota;unknown;Chrysophyceae;Chromulinales;Chromulinaceae;Pedospumella;Pedospumella_sinomuralis;
Zotu640	Eukaryota;unknown;Dinophyceae;Peridiniales;Ostreopsidaceae;Ostreopsis;	Eukaryota;unknown;Dinophyceae;unknown;unknown;unknown;uncultured_dinoflagellate;
Zotu643	Eukaryota;	Eukaryota;Discosea;unknown;Longamoebia;Acanthamoebidae;Acanthamoeba;Acanthamoeba_sp.;
Zotu644	Eukaryota;unknown;	Eukaryota;unknown;Chrysophyceae;Chromulinales;Chromulinaceae;Pedospumella;Pedospumella_sinomuralis;
Zotu647	Eukaryota;	Eukaryota;unknown;Synurophyceae;Ochromonadales;Ochromonadaceae;Cornospumella;Cornospumella_fuschlensis;
Zotu648	Eukaryota;unknown;	Eukaryota;unknown;Chrysophyceae;Chromulinales;Chromulinaceae;Pedospumella;Pedospumella_sp._9-20-C4;
Zotu649	Eukaryota;Oomycota;unknown;Peronosporales;Peronosporaceae;Phytophthora;	Eukaryota;Oomycota;unknown;Peronosporales;Peronosporaceae;Phytophthora;Phytophthora_elongata;
Zotu650	Eukaryota;Oomycota;unknown;Peronosporales;Peronosporaceae;Phytophthora;Phytophthora_x_taiwanensis;	Eukaryota;Oomycota;unknown;Peronosporales;Peronosporaceae;Phytophthora;Phytophthora_x_taiwanensis;
Zotu652	Unknown	Eukaryota;Bacillariophyta;Bacillariophyceae;Naviculales;Naviculaceae;Navicula;Navicula_minima;
Zotu653	Eukaryota;Rotifera;Eurotatoria;Ploima;Trichocercidae;Trichocerca;	Eukaryota;Rotifera;Eurotatoria;Ploima;Trichocercidae;Trichocerca;Trichocerca_stylata;
Zotu654	Eukaryota;unknown;Phaeophyceae;Ectocarpales;	Eukaryota;unknown;Chrysophyceae;Chromulinales;Chromulinaceae;Pedospumella;Pedospumella_sp.;
Zotu655	Eukaryota;unknown;Phaeophyceae;Ectocarpales;Ectocarpaceae;Ectocarpus;Ectocarpus_fasciculatus;	Eukaryota;unknown;Chrysophyceae;Chromulinales;Chromulinaceae;Pedospumella;Pedospumella_sinomuralis;
Zotu657	Eukaryota;Oomycota;unknown;Pythiales;Pythiaceae;	Eukaryota;Oomycota;unknown;Pythiales;Pythiaceae;Pythium;Pythium_aff._pachycaule;
Zotu658	Eukaryota;Chlorophyta;Chlorophyceae;Chlamydomonadales;unknown;Limnomonas;Limnomonas_gaiensis;	Eukaryota;Chlorophyta;Chlorophyceae;Chlamydomonadales;Chlamydomonadaceae;Chlamydomonas;Chlamydomonas_sp._UWO_241;
Zotu659	Eukaryota;Gastrotricha;unknown;Chaetonotida;Chaetonotidae;	Eukaryota;Gastrotricha;unknown;Chaetonotida;Chaetonotidae;Chaetonotus;Chaetonotus_sp._2_MK-2019;
Zotu660	Bacteria;Pseudomonadota;Alphaproteobacteria;Rickettsiales;Rickettsiaceae;Candidatus_Megaera;	Bacteria;Pseudomonadota;Alphaproteobacteria;Rickettsiales;Rickettsiaceae;Candidatus_Megaera;Candidatus_Megaera_polyxenophila;
Zotu661	Eukaryota;unknown;	Eukaryota;unknown;Chrysophyceae;Chromulinales;Chromulinaceae;Pedospumella;Pedospumella_sinomuralis;
Zotu662	Eukaryota;unknown;	Eukaryota;unknown;Phaeophyceae;Ectocarpales;Scytosiphonaceae;Scytosiphon;Scytosiphon_lomentaria;
Zotu665	Eukaryota;Rotifera;Eurotatoria;Ploima;	Eukaryota;Rotifera;Eurotatoria;Ploima;Lecanidae;Lecane;Lecane_leontina;
Zotu667	Eukaryota;Arthropoda;Insecta;Diptera;Chironomidae;Tanytarsus;Tanytarsus_mendax;	Eukaryota;Arthropoda;Insecta;Diptera;Chironomidae;Tanytarsus;Tanytarsus_mendax;
Zotu668	Eukaryota;unknown;Dinophyceae;	Eukaryota;unknown;Dinophyceae;Suessiales;Suessiaceae;Yihiella;Yihiella_yeosuensis;
Zotu669	Eukaryota;	Eukaryota;Basidiomycota;Agaricomycetes;Boletales;Boletaceae;Butyriboletus;Butyriboletus_subappendiculatus;
Zotu670	Unknown	Eukaryota;Rotifera;Eurotatoria;Ploima;Notommatidae;Cephalodella;Cephalodella_binoculata;
Zotu672	Eukaryota;unknown;Phaeophyceae;	Eukaryota;unknown;Chrysophyceae;Chromulinales;Dinobryaceae;Dinobryon;Dinobryon_cylindricollarium;
Zotu673	Eukaryota;	Eukaryota;Chlorophyta;Trebouxiophyceae;Prasiolales;Koliellaceae;Koliella;Koliella_sp._HS-2024a;
Zotu674	Eukaryota;Bacillariophyta;Bacillariophyceae;Naviculales;Sellaphoraceae;Sellaphora;	Eukaryota;Bacillariophyta;Bacillariophyceae;Naviculales;Sellaphoraceae;Sellaphora;Sellaphora_cf._seminulum;
Zotu675	Eukaryota;Ascomycota;	Eukaryota;Ascomycota;Eurotiomycetes;Eurotiales;Aspergillaceae;Penicillium;Penicillium_digitatum;
Zotu676	Eukaryota;Apicomplexa;Conoidasida;Eucoccidiorida;	Eukaryota;Apicomplexa;Conoidasida;Eucoccidiorida;Lankesterellidae;Lankesterella;Lankesterella_sp._(in:_apicomplexans);
Zotu677	Eukaryota;unknown;	Eukaryota;unknown;Chrysophyceae;Chromulinales;Dinobryaceae;Dinobryon;Dinobryon_cylindricum;
Zotu678	Eukaryota;unknown;Chrysophyceae;Chromulinales;Dinobryaceae;Dinobryon;	Eukaryota;unknown;Chrysophyceae;Chromulinales;Dinobryaceae;Dinobryon;Dinobryon_cylindricum;
Zotu679	Eukaryota;unknown;	Eukaryota;unknown;Synurophyceae;Synurales;Mallomonadaceae;Synura;Synura_synuroidea;
Zotu680	Eukaryota;Bacillariophyta;Bacillariophyceae;Naviculales;Sellaphoraceae;Sellaphora;	Eukaryota;Bacillariophyta;Bacillariophyceae;Naviculales;Sellaphoraceae;Sellaphora;Sellaphora_cf._seminulum;
Zotu681	Eukaryota;unknown;Phaeophyceae;Ectocarpales;	Eukaryota;unknown;Phaeophyceae;Ectocarpales;Scytosiphonaceae;Scytosiphon;Scytosiphon_lomentaria;
Zotu682	Eukaryota;Oomycota;unknown;Pythiales;Pythiaceae;	Eukaryota;unknown;Actinophryidae;unknown;unknown;Actinophrys;Actinophrys_sol;
Zotu683	Eukaryota;unknown;Phaeophyceae;Ectocarpales;Chordariaceae;Chordaria;Chordaria_chordaeformis;	Eukaryota;unknown;Phaeophyceae;Ectocarpales;Chordariaceae;Chordaria;Chordaria_chordaeformis;
Zotu684	Eukaryota;Rotifera;Eurotatoria;Ploima;	Eukaryota;Rotifera;Eurotatoria;Ploima;Trichocercidae;Trichocerca;Trichocerca_sp._WM-2017h;
Zotu685	Eukaryota;Oomycota;unknown;	Eukaryota;unknown;Chrysophyceae;Chromulinales;Chromulinaceae;Pedospumella;Pedospumella_sp.;
Zotu686	Eukaryota;Bacillariophyta;Bacillariophyceae;Naviculales;Sellaphoraceae;Sellaphora;	Eukaryota;Bacillariophyta;Bacillariophyceae;Naviculales;Sellaphoraceae;Sellaphora;Sellaphora_cf._seminulum;
Zotu688	Eukaryota;Ascomycota;Sordariomycetes;	Eukaryota;Ascomycota;Sordariomycetes;Hypocreales;Stachybotryaceae;Myrothecium;Myrothecium_inundatum;
Zotu690	Eukaryota;Oomycota;unknown;Peronosporales;Peronosporaceae;Phytophthora;	Eukaryota;Oomycota;unknown;Peronosporales;Peronosporaceae;Phytophthora;Phytophthora_multiplex;
Zotu691	Eukaryota;	Eukaryota;Chlorophyta;Trebouxiophyceae;Prasiolales;Koliellaceae;Koliella;Koliella_sp._HS-2024a;
Zotu692	Eukaryota;unknown;	Eukaryota;unknown;Synurophyceae;Synurales;Mallomonadaceae;Synura;Synura_sphagnicola;
Zotu693	Eukaryota;unknown;	Eukaryota;unknown;Chrysophyceae;Chromulinales;Chromulinaceae;Pedospumella;Pedospumella_sinomuralis;
Zotu694	Eukaryota;	Eukaryota;Chlorophyta;Trebouxiophyceae;Prasiolales;Koliellaceae;Koliella;Koliella_sp._HS-2024a;
Zotu696	Eukaryota;Rhodophyta;Florideophyceae;Ceramiales;Rhodomelaceae;	Eukaryota;Rhodophyta;Florideophyceae;Ceramiales;Rhodomelaceae;Dipterosiphonia;Dipterosiphonia_australica;
Zotu697	Eukaryota;unknown;	Eukaryota;unknown;Synurophyceae;Ochromonadales;Ochromonadaceae;Poterioochromonas;Poterioochromonas_stipitata;
Zotu698	Eukaryota;Rotifera;Eurotatoria;Ploima;	Eukaryota;Rotifera;Eurotatoria;Ploima;Lecanidae;Lecane;Lecane_leontina;
Zotu699	Eukaryota;	Eukaryota;Chlorophyta;Trebouxiophyceae;Prasiolales;Koliellaceae;Koliella;Koliella_sp._HS-2024a;
Zotu701	Eukaryota;unknown;	Eukaryota;unknown;Chrysophyceae;Chromulinales;Dinobryaceae;Dinobryon;Dinobryon_cylindricollarium;
Zotu702	Eukaryota;unknown;Phaeophyceae;Ectocarpales;Chordariaceae;	Eukaryota;unknown;Phaeophyceae;Ectocarpales;Chordariaceae;Leptonematella;Leptonematella_fasciculata;
Zotu704	Eukaryota;unknown;Chrysophyceae;Chromulinales;Dinobryaceae;Dinobryon;	Eukaryota;unknown;Chrysophyceae;Chromulinales;Dinobryaceae;Dinobryon;Dinobryon_cylindricum;
Zotu705	Eukaryota;	Eukaryota;Chlorophyta;Trebouxiophyceae;Prasiolales;Koliellaceae;Koliella;Koliella_sp._HS-2024a;
Zotu707	Eukaryota;unknown;	Eukaryota;unknown;Eustigmatophyceae;Eustigmatales;Monodopsidaceae;Nannochloropsis;Nannochloropsis_limnetica;
Zotu708	Eukaryota;Discosea;unknown;Longamoebia;Acanthamoebidae;Acanthamoeba;	Eukaryota;Discosea;unknown;Longamoebia;Acanthamoebidae;Acanthamoeba;Acanthamoeba_sp.;
Zotu709	Eukaryota;unknown;	Eukaryota;unknown;Synurophyceae;Ochromonadales;Ochromonadaceae;Poterioochromonas;Poterioochromonas_malhamensis;
Zotu710	Eukaryota;Ascomycota;	Eukaryota;Ascomycota;Sordariomycetes;Diaporthales;Diaporthaceae;Diaporthe;Diaporthe_sp.;
Zotu711	Eukaryota;	Eukaryota;unknown;unknown;unknown;unknown;unknown;invertebrate_environmental_sample;
Zotu712	Eukaryota;Rotifera;Eurotatoria;Ploima;Brachionidae;	Eukaryota;Rotifera;Eurotatoria;Ploima;Brachionidae;Keratella;Keratella_cochlearis;
Zotu713	Bacteria;Pseudomonadota;Betaproteobacteria;Nitrosomonadales;Methylophilaceae;	Bacteria;Pseudomonadota;Betaproteobacteria;Nitrosomonadales;Methylophilaceae;Methylotenera;Methylotenera_versatilis;
Zotu714	Eukaryota;	Eukaryota;Chlorophyta;Trebouxiophyceae;Prasiolales;Koliellaceae;Koliella;Koliella_sp._HS-2024a;
Zotu716	Eukaryota;Chytridiomycota;Chytridiomycetes;Synchytriales;Synchytriaceae;Synchytrium;Synchytrium_endobioticum;	Eukaryota;Chytridiomycota;Chytridiomycetes;Synchytriales;Synchytriaceae;Synchytrium;Synchytrium_microbalum;
Zotu719	Eukaryota;unknown;Dinophyceae;	Eukaryota;unknown;Dinophyceae;unknown;unknown;unknown;uncultured_dinoflagellate;
Zotu720	Eukaryota;Oomycota;unknown;Peronosporales;Peronosporaceae;Phytophthora;	Eukaryota;Oomycota;unknown;Peronosporales;Peronosporaceae;Phytophthora;Phytophthora_borneensis;
Zotu721	Eukaryota;Arthropoda;Hexanauplia;Calanoida;	Eukaryota;Arthropoda;Hexanauplia;Calanoida;Pontellidae;unknown;Pontellidae_sp._BIOUG30454-F04;
Zotu722	Eukaryota;unknown;Phaeophyceae;Ectocarpales;Chordariaceae;	Eukaryota;unknown;Phaeophyceae;Ectocarpales;Chordariaceae;unknown;Chordariaceae_sp._7_AP-2014;
Zotu723	Eukaryota;unknown;	Eukaryota;unknown;Chrysophyceae;unknown;unknown;unknown;Chrysophyceae_sp.;
Zotu724	Eukaryota;Arthropoda;Branchiopoda;Diplostraca;Daphniidae;Daphnia;	Eukaryota;Arthropoda;Branchiopoda;Diplostraca;Daphniidae;Daphnia;Daphnia_laevis;
Zotu728	Eukaryota;Bacillariophyta;Bacillariophyceae;Naviculales;Sellaphoraceae;Sellaphora;	Eukaryota;Bacillariophyta;Bacillariophyceae;Naviculales;Sellaphoraceae;Sellaphora;Sellaphora_cf._minima;
Zotu731	Eukaryota;unknown;Chrysophyceae;Chromulinales;Dinobryaceae;Dinobryon;	Eukaryota;unknown;Chrysophyceae;Chromulinales;Dinobryaceae;Dinobryon;Dinobryon_inclinatum;
Zotu732	Eukaryota;unknown;Dinophyceae;Peridiniales;Ostreopsidaceae;Ostreopsis;	Eukaryota;unknown;Dinophyceae;unknown;unknown;unknown;uncultured_dinoflagellate;
Zotu733	Bacteria;Pseudomonadota;Betaproteobacteria;Nitrosomonadales;Methylophilaceae;	Bacteria;Pseudomonadota;Betaproteobacteria;Nitrosomonadales;Methylophilaceae;Methylotenera;Methylotenera_sp.;
Zotu734	Eukaryota;Oomycota;unknown;Peronosporales;Peronosporaceae;Phytophthora;	Eukaryota;Rhodophyta;Bangiophyceae;Bangiales;Bangiaceae;Neoporphyra;Neoporphyra_haitanensis;
Zotu735	Eukaryota;	Eukaryota;unknown;unknown;unknown;unknown;unknown;invertebrate_environmental_sample;
Zotu739	Eukaryota;unknown;	Eukaryota;unknown;Chrysophyceae;Chromulinales;Chromulinaceae;Pedospumella;Pedospumella_sinomuralis;
Zotu740	Eukaryota;unknown;	Eukaryota;unknown;Phaeophyceae;Tilopteridales;Phyllariaceae;Saccorhiza;Saccorhiza_polyschides;
Zotu741	Unknown	Eukaryota;Discosea;Flabellinia;unknown;Vannellidae;Vannella;Vannella_salarenaria;
Zotu742	Unknown	Eukaryota;unknown;Phaeophyceae;Ectocarpales;Acinetosporaceae;unknown;Acinetosporaceae_sp._14_AP-2014;
Zotu743	Eukaryota;unknown;Phaeophyceae;Ectocarpales;	Eukaryota;unknown;Chrysophyceae;Chromulinales;Chromulinaceae;Pedospumella;Pedospumella_sinomuralis;
Zotu744	Unknown	Eukaryota;Rhodophyta;Florideophyceae;unknown;unknown;Peyssonneliopsis;Peyssonneliopsis_sp._2epiphytica;
Zotu747	Eukaryota;Bacillariophyta;Bacillariophyceae;	Eukaryota;Bacillariophyta;Bacillariophyceae;Naviculales;Amphipleuraceae;Frustulia;Frustulia_vulgaris;
Zotu748	Eukaryota;Bacillariophyta;Bacillariophyceae;Naviculales;Pinnulariaceae;Pinnularia;	Eukaryota;Bacillariophyta;Bacillariophyceae;Naviculales;Pinnulariaceae;Pinnularia;Pinnularia_acidicola;
Zotu750	Eukaryota;unknown;Chrysophyceae;Chromulinales;Dinobryaceae;Dinobryon;	Eukaryota;unknown;Chrysophyceae;Chromulinales;Dinobryaceae;Dinobryon;Dinobryon_inclinatum;
Zotu751	Eukaryota;unknown;Chrysophyceae;Chromulinales;Dinobryaceae;Dinobryon;	Eukaryota;unknown;Chrysophyceae;Chromulinales;Dinobryaceae;Dinobryon;Dinobryon_sertularia;
Zotu752	Eukaryota;	Eukaryota;unknown;Phaeophyceae;Dictyotales;Dictyotaceae;Dictyotopsis;Dictyotopsis_propagulifera;
Zotu753	Eukaryota;Discosea;unknown;Longamoebia;Acanthamoebidae;Acanthamoeba;	Eukaryota;Discosea;unknown;Longamoebia;Acanthamoebidae;Acanthamoeba;Acanthamoeba_sp.;
Zotu754	Eukaryota;unknown;	Eukaryota;unknown;Synurophyceae;Synurales;Mallomonadaceae;Synura;Synura_sphagnicola;
Zotu755	Eukaryota;unknown;Phaeophyceae;Ectocarpales;	Eukaryota;unknown;Eustigmatophyceae;Goniochloridales;Goniochloridaceae;Trachydiscus;Trachydiscus_minutus;
Zotu756	Eukaryota;	Eukaryota;Cnidaria;Hydrozoa;Leptothecata;Clytiidae;Clytia;Clytia_sp._JRH-2014;
Zotu757	Eukaryota;Mucoromycota;Mucoromycetes;Mucorales;	Eukaryota;Mucoromycota;Mucoromycetes;Mucorales;Mucoraceae;Mucor;Mucor_piriformis;
Zotu758	Eukaryota;	Eukaryota;unknown;Phaeophyceae;Ectocarpales;Chordariaceae;unknown;Chordariaceae_sp._7_AP-2014;
Zotu760	Bacteria;Pseudomonadota;Betaproteobacteria;Nitrosomonadales;Methylophilaceae;	Bacteria;Pseudomonadota;Betaproteobacteria;Nitrosomonadales;Methylophilaceae;Methylotenera;Methylotenera_versatilis;
Zotu761	Eukaryota;unknown;Phaeophyceae;Ectocarpales;Scytosiphonaceae;	Eukaryota;unknown;Phaeophyceae;Ectocarpales;Acinetosporaceae;Acinetospora;Acinetospora_asiatica;
Zotu762	Eukaryota;Oomycota;unknown;Peronosporales;Peronosporaceae;Phytophthora;Phytophthora_lateralis;	Eukaryota;unknown;Synurophyceae;Synurales;Mallomonadaceae;Synura;Synura_petersenii;
Zotu764	Eukaryota;	Eukaryota;Porifera;Demospongiae;Haplosclerida;Niphatidae;unknown;Niphatidae_sp._4_PRT-2020;
Zotu765	Eukaryota;Rotifera;Eurotatoria;Ploima;Brachionidae;	Eukaryota;Rotifera;Eurotatoria;Ploima;Brachionidae;Euchlanis;Euchlanis_dilatata;
Zotu766	Eukaryota;unknown;	Eukaryota;unknown;Synurophyceae;Synurales;Mallomonadaceae;Synura;Synura_petersenii;
Zotu767	Eukaryota;	Eukaryota;Chlorophyta;Trebouxiophyceae;Prasiolales;Koliellaceae;Koliella;Koliella_corcontica;
Zotu768	Eukaryota;	Eukaryota;unknown;Chrysophyceae;Chromulinales;Chromulinaceae;Pedospumella;Pedospumella_sinomuralis;
Zotu769	Eukaryota;unknown;Dinophyceae;	Eukaryota;unknown;Dinophyceae;unknown;unknown;unknown;uncultured_dinoflagellate;
Zotu772	Unknown	Eukaryota;Chytridiomycota;Chytridiomycetes;Synchytriales;Synchytriaceae;Synchytrium;Synchytrium_microbalum;
Zotu774	Eukaryota;unknown;	Eukaryota;unknown;Chrysophyceae;Chromulinales;Dinobryaceae;Dinobryon;Dinobryon_similis;
Zotu775	Eukaryota;Arthropoda;Branchiopoda;Diplostraca;Holopediidae;Holopedium;Holopedium_glacialis;	Eukaryota;Arthropoda;Branchiopoda;Diplostraca;Holopediidae;Holopedium;Holopedium_glacialis;
Zotu776	Eukaryota;unknown;Phaeophyceae;Ectocarpales;Ectocarpaceae;Ectocarpus;Ectocarpus_siliculosus;	Eukaryota;unknown;Phaeophyceae;Ectocarpales;Ectocarpaceae;Ectocarpus;Ectocarpus_siliculosus;
Zotu777	Eukaryota;unknown;	Eukaryota;unknown;Eustigmatophyceae;Eustigmatales;Monodopsidaceae;Nannochloropsis;Nannochloropsis_limnetica;
Zotu778	Eukaryota;	Eukaryota;unknown;Synurophyceae;Synurales;Mallomonadaceae;Synura;Synura_petersenii;
Zotu779	Unknown	Eukaryota;unknown;Phaeophyceae;Ectocarpales;Chordariaceae;Myriotrichia;Myriotrichia_sp._1Norway;
Zotu780	Eukaryota;unknown;Dinophyceae;	Eukaryota;unknown;Dinophyceae;Suessiales;Suessiaceae;Yihiella;Yihiella_yeosuensis;
Zotu781	Eukaryota;unknown;Phaeophyceae;Ectocarpales;Chordariaceae;	Eukaryota;unknown;Chrysophyceae;Chromulinales;Chromulinaceae;Pedospumella;Pedospumella_sinomuralis;
Zotu782	Eukaryota;	Eukaryota;unknown;Synurophyceae;Synurales;Mallomonadaceae;Synura;Synura_petersenii;
Zotu783	Eukaryota;	Eukaryota;unknown;Chrysophyceae;Chromulinales;Dinobryaceae;Dinobryon;Dinobryon_inclinatum;
Zotu784	Eukaryota;unknown;Dinophyceae;	Eukaryota;unknown;Dinophyceae;unknown;unknown;unknown;uncultured_dinoflagellate;
Zotu785	Eukaryota;unknown;Phaeophyceae;Ectocarpales;Scytosiphonaceae;Petalonia;Petalonia_fascia;	Eukaryota;unknown;Dictyochophyceae;Florenciellales;unknown;Florenciella;Florenciella_parvula;
Zotu786	Eukaryota;Arthropoda;Branchiopoda;Diplostraca;Holopediidae;Holopedium;Holopedium_glacialis;	Eukaryota;Arthropoda;Branchiopoda;Diplostraca;Holopediidae;Holopedium;Holopedium_glacialis;
Zotu787	Eukaryota;unknown;Phaeophyceae;Ectocarpales;Scytosiphonaceae;Petalonia;Petalonia_fascia;	Eukaryota;unknown;Phaeophyceae;Ectocarpales;Scytosiphonaceae;Petalonia;Petalonia_fascia;
Zotu788	Eukaryota;Arthropoda;Branchiopoda;Diplostraca;Holopediidae;Holopedium;Holopedium_glacialis;	Eukaryota;Arthropoda;Branchiopoda;Diplostraca;Holopediidae;Holopedium;Holopedium_glacialis;
Zotu790	Eukaryota;Arthropoda;Branchiopoda;Diplostraca;Daphniidae;Daphnia;	Eukaryota;Arthropoda;Branchiopoda;Diplostraca;Daphniidae;Daphnia;Daphnia_mendotae;
Zotu792	Eukaryota;Arthropoda;	Eukaryota;Arthropoda;Arachnida;Araneae;Clubionidae;Clubiona;Clubiona_circulata;
Zotu793	Eukaryota;Oomycota;unknown;Pythiales;Pythiaceae;	Eukaryota;unknown;Actinophryidae;unknown;unknown;Actinophrys;Actinophrys_sol;
Zotu794	Eukaryota;unknown;	Eukaryota;unknown;Chrysophyceae;Chromulinales;Chromulinaceae;Pedospumella;Pedospumella_sinomuralis;
Zotu796	Eukaryota;unknown;	Eukaryota;unknown;Chrysophyceae;Chromulinales;Chromulinaceae;Pedospumella;Pedospumella_sinomuralis;
Zotu799	Eukaryota;Oomycota;unknown;Peronosporales;Peronosporaceae;Phytophthora;	Eukaryota;Rhodophyta;Bangiophyceae;Bangiales;Bangiaceae;Neoporphyra;Neoporphyra_haitanensis;
Zotu800	Eukaryota;	Eukaryota;Oomycota;unknown;Pythiales;Pythiaceae;Pythium;Pythium_sp.;
Zotu803	Eukaryota;	Eukaryota;Chlorophyta;Trebouxiophyceae;Chlorellales;Chlorellaceae;Marvania;Marvania_coccoides;
Zotu804	Eukaryota;unknown;Phaeophyceae;Ectocarpales;Chordariaceae;Chordaria;Chordaria_chordaeformis;	Eukaryota;unknown;Phaeophyceae;Ectocarpales;Chordariaceae;Chordaria;Chordaria_chordaeformis;
Zotu806	Eukaryota;unknown;Phaeophyceae;Ectocarpales;Chordariaceae;Microspongium;Microspongium_tenuissimum;	Eukaryota;unknown;Phaeophyceae;Ectocarpales;Chordariaceae;Microspongium;Microspongium_tenuissimum;
Zotu807	Eukaryota;unknown;	Eukaryota;unknown;Chrysophyceae;Chromulinales;Chromulinaceae;Pedospumella;Pedospumella_sinomuralis;
Zotu808	Eukaryota;unknown;	Eukaryota;unknown;Chrysophyceae;Chromulinales;Chromulinaceae;Pedospumella;Pedospumella_sinomuralis;
Zotu809	Eukaryota;Oomycota;unknown;Saprolegniales;Saprolegniaceae;	Eukaryota;Oomycota;unknown;Saprolegniales;Saprolegniaceae;Saprolegnia;Saprolegnia_anisospora;
Zotu811	Eukaryota;unknown;	Eukaryota;unknown;Phaeophyceae;Laminariales;Alariaceae;Pleurophycus;Pleurophycus_gardneri;
Zotu812	Eukaryota;	Eukaryota;unknown;Chrysophyceae;Chromulinales;Chromulinaceae;Pedospumella;Pedospumella_sinomuralis;
Zotu815	Eukaryota;Rotifera;Eurotatoria;Ploima;Brachionidae;	Eukaryota;Rotifera;Eurotatoria;Ploima;Brachionidae;Euchlanis;Euchlanis_dilatata;
Zotu817	Eukaryota;unknown;Phaeophyceae;Ectocarpales;Chordariaceae;Chordaria;Chordaria_chordaeformis;	Eukaryota;unknown;Phaeophyceae;Ectocarpales;Chordariaceae;Chordaria;Chordaria_chordaeformis;
Zotu818	Eukaryota;unknown;Phaeophyceae;Ectocarpales;Chordariaceae;Chordaria;Chordaria_chordaeformis;	Eukaryota;unknown;Phaeophyceae;Ectocarpales;Chordariaceae;Chordaria;Chordaria_chordaeformis;
Zotu819	Eukaryota;unknown;	Eukaryota;unknown;Synurophyceae;Synurales;Mallomonadaceae;Synura;Synura_synuroidea;
Zotu820	Eukaryota;unknown;	Eukaryota;unknown;Chrysophyceae;Chromulinales;Dinobryaceae;Dinobryon;Dinobryon_cylindricum;
Zotu821	Eukaryota;Bacillariophyta;	Eukaryota;Bacillariophyta;Mediophyceae;Lithodesmiales;Lithodesmiaceae;Lithodesmium;Lithodesmium_intricatum;
Zotu822	Eukaryota;unknown;	Eukaryota;unknown;Chrysophyceae;Chromulinales;Dinobryaceae;Dinobryon;Dinobryon_inclinatum;
Zotu823	Eukaryota;Arthropoda;Branchiopoda;Diplostraca;Holopediidae;Holopedium;	Eukaryota;Arthropoda;Branchiopoda;Diplostraca;Holopediidae;Holopedium;Holopedium_glacialis;
Zotu824	Eukaryota;Rotifera;Eurotatoria;Ploima;	Eukaryota;Rotifera;Eurotatoria;Ploima;Brachionidae;Keratella;Keratella_sp._STE97;
Zotu825	Eukaryota;unknown;	Eukaryota;unknown;Synurophyceae;Ochromonadales;Ochromonadaceae;Poterioochromonas;Poterioochromonas_malhamensis;
Zotu826	Eukaryota;unknown;	Eukaryota;unknown;Synurophyceae;Ochromonadales;Ochromonadaceae;Poterioochromonas;Poterioochromonas_malhamensis;
Zotu829	Eukaryota;Rotifera;Eurotatoria;Ploima;	Eukaryota;Rotifera;Eurotatoria;Ploima;Brachionidae;Brachionus;Brachionus_sp._WM-2017m;
Zotu830	Eukaryota;unknown;Dinophyceae;Peridiniales;Ostreopsidaceae;Ostreopsis;	Eukaryota;unknown;Dinophyceae;unknown;unknown;unknown;uncultured_dinoflagellate;
Zotu831	Eukaryota;Arthropoda;Hexanauplia;Calanoida;Diaptomidae;Leptodiaptomus;Leptodiaptomus_minutus;	Eukaryota;Arthropoda;Hexanauplia;Calanoida;Pontellidae;unknown;Pontellidae_sp._BIOUG30454-F04;
Zotu832	Eukaryota;unknown;Phaeophyceae;	Eukaryota;unknown;Phaeophyceae;Dictyotales;Dictyotaceae;Dictyota;Dictyota_guineensis;
Zotu833	Eukaryota;Rotifera;Eurotatoria;Ploima;Synchaetidae;Synchaeta;	Eukaryota;Rotifera;Eurotatoria;Ploima;Synchaetidae;Synchaeta;Synchaeta_gyrina;
Zotu834	Unknown	Eukaryota;Streptophyta;Lycopodiopsida;Lycopodiales;Lycopodiaceae;Phlegmariurus;Phlegmariurus_squarrosus;
Zotu835	Eukaryota;Rotifera;Eurotatoria;Ploima;	Eukaryota;Rotifera;Eurotatoria;Ploima;Brachionidae;Euchlanis;Euchlanis_dilatata;
Zotu836	Eukaryota;unknown;Chrysophyceae;	Eukaryota;unknown;Chrysophyceae;Chromulinales;Dinobryaceae;Dinobryon;Dinobryon_cylindricollarium;
Zotu838	Eukaryota;Arthropoda;Hexanauplia;Calanoida;Diaptomidae;Leptodiaptomus;Leptodiaptomus_minutus;	Eukaryota;Arthropoda;Hexanauplia;Calanoida;Diaptomidae;Leptodiaptomus;Leptodiaptomus_minutus;
Zotu839	Eukaryota;unknown;Phaeophyceae;Ectocarpales;Chordariaceae;Chordaria;Chordaria_chordaeformis;	Eukaryota;unknown;Phaeophyceae;Ectocarpales;Chordariaceae;Leptonematella;Leptonematella_fasciculata;
Zotu840	Eukaryota;Arthropoda;Hexanauplia;Calanoida;Diaptomidae;Leptodiaptomus;Leptodiaptomus_minutus;	Eukaryota;Arthropoda;Hexanauplia;Calanoida;Diaptomidae;Leptodiaptomus;Leptodiaptomus_minutus;
Zotu841	Eukaryota;unknown;Chrysophyceae;Chromulinales;	Eukaryota;unknown;Chrysophyceae;Chromulinales;Dinobryaceae;Dinobryon;Dinobryon_sociale;
Zotu842	Eukaryota;Porifera;Demospongiae;Bubarida;Dictyonellidae;Scopalina;Scopalina_ruetzleri;	Eukaryota;Porifera;Demospongiae;Bubarida;Dictyonellidae;Scopalina;Scopalina_ruetzleri;
Zotu843	Eukaryota;unknown;	Eukaryota;unknown;Synurophyceae;Ochromonadales;Ochromonadaceae;Cornospumella;Cornospumella_fuschlensis;
Zotu844	Eukaryota;unknown;Raphidophyceae;Chattonellales;Chattonellaceae;Heterosigma;Heterosigma_akashiwo;	Eukaryota;unknown;unknown;unknown;unknown;unknown;Stramenopiles_sp.;
Zotu845	Bacteria;Pseudomonadota;Alphaproteobacteria;Rickettsiales;Rickettsiaceae;Candidatus_Megaera;	Bacteria;Pseudomonadota;Alphaproteobacteria;Rickettsiales;Rickettsiaceae;Candidatus_Megaera;Candidatus_Megaira_endosymbiont_of_Mesostigma_viride;
Zotu846	Eukaryota;unknown;	Eukaryota;unknown;Synurophyceae;Ochromonadales;Ochromonadaceae;Poterioochromonas;Poterioochromonas_malhamensis;
Zotu847	Eukaryota;unknown;	Eukaryota;unknown;Chrysophyceae;Chromulinales;Dinobryaceae;Dinobryon;Dinobryon_balticum;
Zotu850	Eukaryota;unknown;	Eukaryota;unknown;Synurophyceae;Ochromonadales;Ochromonadaceae;Poterioochromonas;Poterioochromonas_malhamensis;
Zotu852	Eukaryota;unknown;Phaeophyceae;	Eukaryota;unknown;Chrysophyceae;Chromulinales;Chromulinaceae;Pedospumella;Pedospumella_sinomuralis;
Zotu853	Eukaryota;unknown;Phaeophyceae;	Eukaryota;unknown;Phaeophyceae;Dictyotales;Dictyotaceae;Dictyota;Dictyota_spiralis;
Zotu854	Eukaryota;	Eukaryota;Bacillariophyta;Coscinodiscophyceae;Melosirales;Stephanopyxidaceae;Stephanopyxis;Stephanopyxis_turris;
Zotu855	Eukaryota;unknown;Phaeophyceae;Ectocarpales;Chordariaceae;Polycerea;Polycerea_nigrescens;	Eukaryota;unknown;Phaeophyceae;Ectocarpales;Chordariaceae;Polycerea;Polycerea_nigrescens;
Zotu856	Unknown	Eukaryota;unknown;Phaeophyceae;Ectocarpales;Chordariaceae;unknown;Chordariaceae_sp.;
Zotu857	Eukaryota;unknown;Phaeophyceae;Ectocarpales;	Eukaryota;unknown;Phaeophyceae;Ectocarpales;Scytosiphonaceae;Colpomenia;Colpomenia_sinuosa;
Zotu858	Eukaryota;unknown;Phaeophyceae;Ectocarpales;Scytosiphonaceae;Scytosiphon;	Eukaryota;unknown;Eustigmatophyceae;Goniochloridales;Goniochloridaceae;Trachydiscus;Trachydiscus_minutus;
Zotu860	Unknown	Eukaryota;Rotifera;Eurotatoria;Ploima;Brachionidae;Brachionus;Brachionus_sp._BIOUG30063-G04;
Zotu861	Eukaryota;Rotifera;Eurotatoria;Ploima;Trichocercidae;Trichocerca;	Eukaryota;Rotifera;Eurotatoria;Ploima;Trichocercidae;Trichocerca;Trichocerca_sp._WM-2017d;
Zotu862	Eukaryota;unknown;Phaeophyceae;Ectocarpales;Scytosiphonaceae;Petalonia;Petalonia_fascia;	Eukaryota;unknown;Phaeophyceae;Ectocarpales;Scytosiphonaceae;Petalonia;Petalonia_fascia;
Zotu863	Unknown	Eukaryota;Mollusca;Gastropoda;Stylommatophora;Camaenidae;Amphidromus;Amphidromus_dautzenbergi;
Zotu864	Bacteria;Pseudomonadota;Alphaproteobacteria;Rickettsiales;Rickettsiaceae;	Bacteria;Pseudomonadota;Alphaproteobacteria;Rickettsiales;Rickettsiaceae;Candidatus_Megaera;Candidatus_Megaera_polyxenophila;
Zotu865	Eukaryota;Rotifera;Eurotatoria;unknown;unknown;Rotaria;	Eukaryota;Rotifera;Eurotatoria;unknown;unknown;Rotaria;Rotaria_macrura;
Zotu866	Unknown	Eukaryota;Streptophyta;Zygnemophyceae;Desmidiales;Closteriaceae;Closterium;Closterium_baillyanum;
Zotu867	Eukaryota;Bacillariophyta;	Eukaryota;Bacillariophyta;Mediophyceae;Hemiaulales;Hemiaulaceae;Hemiaulus;Hemiaulus_sinensis;
Zotu868	Eukaryota;Oomycota;unknown;	Eukaryota;Oomycota;unknown;Peronosporales;Peronosporaceae;Phytophthora;Phytophthora_sp._'lagoariana';
Zotu870	Eukaryota;Rotifera;Eurotatoria;Ploima;Brachionidae;Keratella;Keratella_cochlearis;	Eukaryota;Rotifera;Eurotatoria;Ploima;Brachionidae;Keratella;Keratella_cochlearis;
Zotu872	Unknown	Eukaryota;Streptophyta;Zygnemophyceae;Desmidiales;Closteriaceae;Closterium;Closterium_baillyanum;
Zotu873	Eukaryota;unknown;Phaeophyceae;Ectocarpales;Chordariaceae;	Eukaryota;unknown;Phaeophyceae;Ectocarpales;Chordariaceae;unknown;Chordariaceae_sp._7_AP-2014;
Zotu874	Unknown	Eukaryota;Streptophyta;Lycopodiopsida;Lycopodiales;Lycopodiaceae;Phlegmariurus;Phlegmariurus_squarrosus;
Zotu875	Eukaryota;unknown;	Eukaryota;unknown;Chrysophyceae;Chromulinales;Dinobryaceae;Dinobryon;Dinobryon_cylindricollarium;
Zotu877	Eukaryota;Rotifera;Eurotatoria;Ploima;	Eukaryota;Rotifera;Eurotatoria;Ploima;Brachionidae;Euchlanis;Euchlanis_dilatata;
Zotu878	Eukaryota;unknown;Raphidophyceae;Chattonellales;Chattonellaceae;Chattonella;Chattonella_marina;	Eukaryota;unknown;Chrysophyceae;Chromulinales;Dinobryaceae;Dinobryon;Dinobryon_similis;
Zotu879	Unknown	Eukaryota;Streptophyta;Zygnemophyceae;Desmidiales;Closteriaceae;Closterium;Closterium_baillyanum;
Zotu880	Eukaryota;unknown;Phaeophyceae;Ectocarpales;Chordariaceae;Chordaria;Chordaria_chordaeformis;	Eukaryota;unknown;Phaeophyceae;Ectocarpales;Chordariaceae;Chordaria;Chordaria_chordaeformis;
Zotu881	Eukaryota;	Eukaryota;unknown;unknown;unknown;unknown;unknown;zooplankton_environmental_sample;
Zotu882	Eukaryota;Rotifera;Eurotatoria;Ploima;Synchaetidae;Polyarthra;Polyarthra_dolichoptera_complex_sp._UO-2013;	Eukaryota;Rotifera;Eurotatoria;Ploima;Synchaetidae;Polyarthra;Polyarthra_dolichoptera_complex_sp._UO-2013;
Zotu883	Eukaryota;Rotifera;Eurotatoria;Ploima;	Eukaryota;Rotifera;Eurotatoria;Ploima;Brachionidae;Kellicottia;Kellicottia_bostoniensis;
Zotu884	Eukaryota;unknown;	Eukaryota;unknown;Chrysophyceae;Chromulinales;Chromulinaceae;Pedospumella;Pedospumella_sp.;
Zotu885	Eukaryota;unknown;Dinophyceae;	Eukaryota;unknown;Dinophyceae;unknown;unknown;unknown;uncultured_dinoflagellate;
Zotu886	Eukaryota;unknown;	Eukaryota;unknown;Chrysophyceae;Chromulinales;Chromulinaceae;Pedospumella;Pedospumella_sinomuralis;
Zotu887	Eukaryota;unknown;Dinophyceae;	Eukaryota;unknown;Dinophyceae;unknown;unknown;unknown;uncultured_dinoflagellate;
Zotu888	Eukaryota;	Eukaryota;unknown;Phaeophyceae;Dictyotales;Dictyotaceae;Dictyota;Dictyota_sp._10FP;
Zotu890	Eukaryota;Bacillariophyta;Bacillariophyceae;Naviculales;Sellaphoraceae;Sellaphora;	Eukaryota;Bacillariophyta;Bacillariophyceae;Naviculales;Sellaphoraceae;Sellaphora;Sellaphora_cf._seminulum;
Zotu891	Eukaryota;Oomycota;unknown;	Eukaryota;Oomycota;unknown;Pythiales;Pythiaceae;Globisporangium;Globisporangium_irregulare;
Zotu892	Eukaryota;Rotifera;Eurotatoria;Ploima;Brachionidae;Euchlanis;Euchlanis_dilatata;	Eukaryota;Rotifera;Eurotatoria;Ploima;Brachionidae;Euchlanis;Euchlanis_dilatata;
Zotu894	Eukaryota;unknown;Phaeophyceae;Ectocarpales;Chordariaceae;	Eukaryota;unknown;Phaeophyceae;Ectocarpales;Chordariaceae;Leptonematella;Leptonematella_fasciculata;
Zotu895	Eukaryota;unknown;	Eukaryota;unknown;Eustigmatophyceae;Eustigmatales;Monodopsidaceae;Nannochloropsis;Nannochloropsis_limnetica;
Zotu896	Eukaryota;unknown;Chrysophyceae;Chromulinales;	Eukaryota;unknown;Synurophyceae;Synurales;Mallomonadaceae;Mallomonas;Mallomonas_sp.;
Zotu898	Eukaryota;Arthropoda;Branchiopoda;Diplostraca;Holopediidae;Holopedium;Holopedium_glacialis;	Eukaryota;Arthropoda;Branchiopoda;Diplostraca;Holopediidae;Holopedium;Holopedium_glacialis;
Zotu900	Eukaryota;unknown;Phaeophyceae;Ectocarpales;Chordariaceae;Chordaria;Chordaria_chordaeformis;	Eukaryota;unknown;Phaeophyceae;Ectocarpales;Chordariaceae;Chordaria;Chordaria_chordaeformis;
Zotu901	Eukaryota;	Eukaryota;unknown;unknown;unknown;unknown;unknown;invertebrate_environmental_sample;
Zotu902	Eukaryota;unknown;	Eukaryota;unknown;Chrysophyceae;Chromulinales;Dinobryaceae;Epipyxis;Epipyxis_sp.;
Zotu903	Eukaryota;Rotifera;Eurotatoria;Ploima;Synchaetidae;Polyarthra;Polyarthra_dolichoptera_complex_sp._UO-2013;	Eukaryota;Rotifera;Eurotatoria;Ploima;Synchaetidae;Polyarthra;Polyarthra_dolichoptera_complex_sp._UO-2013;
Zotu904	Eukaryota;unknown;Chrysophyceae;Chromulinales;Dinobryaceae;Dinobryon;	Eukaryota;unknown;Chrysophyceae;Chromulinales;Dinobryaceae;Dinobryon;Dinobryon_sertularia;
Zotu906	Eukaryota;unknown;	Eukaryota;unknown;Synurophyceae;Synurales;Mallomonadaceae;Synura;Synura_synuroidea;
Zotu908	Eukaryota;Rotifera;Eurotatoria;Ploima;	Eukaryota;Rotifera;Eurotatoria;Ploima;Epiphanidae;Cyrtonia;Cyrtonia_tuba;
Zotu909	Eukaryota;Rotifera;Eurotatoria;Ploima;Brachionidae;Keratella;Keratella_cochlearis;	Eukaryota;Rotifera;Eurotatoria;Ploima;Brachionidae;Keratella;Keratella_cochlearis;
Zotu910	Eukaryota;unknown;Phaeophyceae;Ectocarpales;Scytosiphonaceae;Petalonia;Petalonia_fascia;	Eukaryota;unknown;Chrysophyceae;Chromulinales;Chromulinaceae;Pedospumella;Pedospumella_sinomuralis;
Zotu911	Eukaryota;unknown;Dinophyceae;	Eukaryota;unknown;Dinophyceae;unknown;unknown;unknown;uncultured_dinoflagellate;
Zotu912	Eukaryota;Rotifera;Eurotatoria;Ploima;Brachionidae;	Eukaryota;Rotifera;Eurotatoria;Ploima;Brachionidae;Keratella;Keratella_cochlearis;
Zotu913	Eukaryota;unknown;Chrysophyceae;Chromulinales;Dinobryaceae;Dinobryon;	Eukaryota;unknown;Chrysophyceae;Chromulinales;Dinobryaceae;Dinobryon;Dinobryon_inclinatum;
Zotu914	Eukaryota;Rotifera;Eurotatoria;Ploima;	Eukaryota;Rotifera;Eurotatoria;Ploima;Brachionidae;Euchlanis;Euchlanis_dilatata;
Zotu915	Eukaryota;Arthropoda;Hexanauplia;Calanoida;Diaptomidae;Leptodiaptomus;Leptodiaptomus_minutus;	Eukaryota;Arthropoda;Hexanauplia;Calanoida;Diaptomidae;Leptodiaptomus;Leptodiaptomus_minutus;
Zotu916	Eukaryota;	Eukaryota;Mollusca;Gastropoda;unknown;Pachychilidae;Sulcospira;Sulcospira_paludiformis;
Zotu917	Eukaryota;Rotifera;Eurotatoria;Ploima;Synchaetidae;Polyarthra;	Eukaryota;Rotifera;Eurotatoria;Ploima;Synchaetidae;Polyarthra;Polyarthra_sp._WM-2017a;
Zotu918	Eukaryota;Rotifera;Eurotatoria;Ploima;	Eukaryota;Rotifera;Eurotatoria;Ploima;Trichocercidae;unknown;Trichocercidae_sp._SHCX151203c;
Zotu921	Eukaryota;	Eukaryota;Cnidaria;Scyphozoa;Semaeostomeae;Cyaneidae;Cyanea;Cyanea_capillata;
Zotu922	Eukaryota;Rotifera;Eurotatoria;Ploima;Brachionidae;	Eukaryota;Rotifera;Eurotatoria;Ploima;Brachionidae;Keratella;Keratella_cochlearis;
Zotu923	Eukaryota;unknown;Phaeophyceae;Ectocarpales;	Eukaryota;unknown;Phaeophyceae;Ectocarpales;Chordariaceae;Laminarionema;Laminarionema_elsbetiae;
Zotu924	Eukaryota;	Eukaryota;unknown;Synurophyceae;Synurales;Mallomonadaceae;Synura;Synura_petersenii;
Zotu926	Unknown	Eukaryota;Streptophyta;Magnoliopsida;Alismatales;Hydrocharitaceae;Thalassia;Thalassia_hemprichii;
Zotu927	Eukaryota;unknown;Raphidophyceae;Chattonellales;Chattonellaceae;Chattonella;Chattonella_marina;	Eukaryota;unknown;Raphidophyceae;Chattonellales;Chattonellaceae;Chattonella;Chattonella_marina;
Zotu928	Unknown	Eukaryota;unknown;Phaeophyceae;Ectocarpales;Chordariaceae;Myriotrichia;Myriotrichia_sp._1Norway;
