Zotu2	Eukaryota;Ochrophyta;Synurophyceae;Synurales;Mallomonadaceae;Synura_petersenii;
Zotu3	Eukaryota;Arthropoda;Hexanauplia;Calanoida;Diaptomidae;Leptodiaptomus_minutus;
Zotu4	Eukaryota;Chlorophyta;Trebouxiophyceae;Trebouxiophyceae ordo;Coccomyxaceae;unknown_microalga;
Zotu5	Eukaryota;Rotifera;Eurotatoria;Ploima;Brachionidae;Keratella_spp.;
Zotu8	Eukaryota;Rotifera;Eurotatoria;Ploima;Synchaetidae;Polyarthra_spp.;
Zotu9	Eukaryota;Rotifera;Eurotatoria;Ploima;Trichocercidae;unknown_rotifera;
Zotu12	Eukaryota;Rotifera;Eurotatoria;Ploima;Synchaetidae;Polyarthra_spp.;
Zotu13	Eukaryota;Ochrophyta;Raphidophyceae;Chattonellales;Chattonellaceae;Chattonella_marina;
Zotu15	Eukaryota;Ochrophyta;Raphidophyceae;Chattonellales;Chattonellaceae;Chattonella_marina;
Zotu16	Eukaryota;Ochrophyta;Raphidophyceae;Chattonellales;Chattonellaceae;Chattonella_marina;
Zotu17	Eukaryota;Ochrophyta;Raphidophyceae;Chattonellales;Chattonellaceae;Chattonella_marina;
Zotu18	Eukaryota;Rotifera;Eurotatoria;Ploima;Asplanchnidae;Asplanchna_brightwellii;
Zotu19	Eukaryota;Rotifera;Eurotatoria;Ploima;Brachionidae;Kellicottia_bostoniensis;
Zotu23	Eukaryota;Rotifera;unknown;unknown;unknown;unknown_rotifera;
Zotu24	Eukaryota;Ochrophyta;Raphidophyceae;Chattonellales;Chattonellaceae;Chattonella_marina;
Zotu26	Eukaryota;Rotifera;Eurotatoria;Ploima;Trichocercidae;Trichocerca_;
Zotu28	Eukaryota;Rotifera;Eurotatoria;Ploima;Trichocercidae;Trichocerca_spp.;
Zotu29	Eukaryota;Chlorophyta;Trebouxiophyceae;Trebouxiales;unknown;Choricystis_spp.;
Zotu30	Eukaryota;Rotifera;Eurotatoria;Ploima;Brachionidae;Keratella_spp.;
Zotu32	Eukaryota;Ochrophyta;Chrysophyceae;Chromulinales;Dinobryaceae;Dinobryon_similis;
Zotu34	Eukaryota;Arthropoda;Hexanauplia;Calanoida;Diaptomidae;Leptodiaptomus_minutus;
Zotu35	Eukaryota;Ochrophyta;Chrysophyceae;Chromulinales;Chromulinaceae;Pedospumella_spp.;
Zotu36	Eukaryota;Gastrotricha;Paucitubulatina ;Chaetonotida;Chaetonotidae;Lepidodermella_broa;
Zotu37	Bacteria;Pseudomonadota;Alphaproteobacteria;Rickettsiales;Rickettsiaceae;unknown_bacterium;
Zotu38	Eukaryota;Ochrophyta;Raphidophyceae;Chattonellales;Chattonellaceae;Chattonella_marina;
Zotu39	Eukaryota;Arthropoda;Hexanauplia;Calanoida;Pontellidae;unknown_copepod;
Zotu40	Eukaryota;Ochrophyta;Chrysophyceae;Chromulinales;Dinobryaceae;Dinobryon_similis;
Zotu42	Eukaryota;Rotifera;Eurotatoria;Ploima;Asplanchnidae;Asplanchna_priodonta;
Zotu43	Eukaryota;Bacillariophyta;Coscinodiscophyceae;Thalassiosirales;Thalassiosiraceae;Thalassiosira_pseudonana;
Zotu44	Eukaryota;Arthropoda;Branchiopoda;Diplostraca;Holopediidae;Holopedium_glacialis;
Zotu46	Eukaryota;Ochrophyta;Phaeophyceae;Ectocarpales;Scytosiphonaceae;Petalonia_tenella;
Zotu47	Eukaryota;Arthropoda;Hexanauplia;Calanoida;Pontellidae;unknown_copepod;
Zotu49	Eukaryota;Rotifera;Eurotatoria;Ploima;Trichocercidae;Trichocerca_spp.;
Zotu50	Eukaryota;Ochrophyta;Raphidophyceae;Chattonellales;Chattonellaceae;Chattonella_marina;
Zotu52	Eukaryota;Ochrophyta;Phaeophyceae;Ectocarpales;Chordariaceae;Leptonematella_fasciculata;
Zotu55	Eukaryota;Ochrophyta;Synurophyceae;Synurales;Mallomonadaceae;Synura_petersenii;
Zotu57	Eukaryota;Ochrophyta;Phaeophyceae;Ectocarpales;Chordariaceae;Laminarionema_elsbetiae;
Zotu58	Eukaryota;Chlorophyta;Trebouxiophyceae;Trebouxiales;unknown;Choricystis_spp.;
Zotu63	Eukaryota;Arthropoda;Branchiopoda;Diplostraca;Daphniidae;Daphnia_dubia;
Zotu64	Eukaryota;Ochrophyta;Raphidophyceae;Chattonellales;Chattonellaceae;Chattonella_marina;
Zotu65	Eukaryota;Rotifera;Eurotatoria;Ploima;Asplanchnidae;Asplanchna_priodonta;
Zotu67	Eukaryota;Arthropoda;Hexanauplia;Calanoida;Diaptomidae;Leptodiaptomus_minutus;
Zotu68	Eukaryota;Arthropoda;Insecta;Hymenoptera;Formicidae;Adelomyrmex_spp.;
Zotu70	Eukaryota;Ochrophyta;Chrysophyceae;Chromulinales;Dinobryaceae;Dinobryon_cylindricollarium;
Zotu71	Eukaryota;Rotifera;Eurotatoria;Ploima;Brachionidae;Keratella_spp.;
Zotu72	Eukaryota;Rotifera;Eurotatoria;Ploima;Trichocercidae;Trichocerca_spp.;
Zotu73	Eukaryota;Ochrophyta;Raphidophyceae;Chattonellales;Chattonellaceae;Chattonella_marina;
Zotu74	Eukaryota;Ascomycota;Sordariomycetes;Hypocreales;Hypocreaceae;Trichoderma_atroviride;
Zotu75	Eukaryota;Ochrophyta;Chrysophyceae;Chromulinales;Chromulinaceae;Pedospumella_spp.;
Zotu77	Eukaryota;Ochrophyta;Eustigmatophyceae;Eustigmatales;Monodopsidaceae;Nannochloropsis_limnetica;
Zotu78	Eukaryota;Arthropoda;Branchiopoda;Diplostraca;Daphniidae;Daphnia_dubia;
Zotu79	Eukaryota;Bacillariophyta;Coscinodiscophyceae;Coscinodiscales;Coscinodiscaceae;Coscinodiscus_wailesii;
Zotu80	Eukaryota;Oomycota;Oomycetes;Peronosporales;Peronosporaceae;Phytophthora_tenuimura;
Zotu81	Bacteria;Pseudomonadota;Alphaproteobacteria;Rickettsiales;Rickettsiaceae;unknown_bacterium;
Zotu83	Eukaryota;Arthropoda;Hexanauplia;Calanoida;Pontellidae;unknown_copepod;
Zotu85	Eukaryota;Arthropoda;Hexanauplia;Calanoida;Pontellidae;unknown_copepod;
Zotu86	Eukaryota;Ochrophyta;Raphidophyceae;Chattonellales;Chattonellaceae;Chattonella_marina;
Zotu87	Eukaryota;Rotifera;Eurotatoria;Ploima;Synchaetidae;Polyarthra_dolichoptera;
Zotu88	Bacteria;Pseudomonadota;Alphaproteobacteria;Rickettsiales;Anaplasmataceae;unknown_bacterium;
Zotu89	Eukaryota;Rotifera;Eurotatoria;Ploima;Synchaetidae;Synchaeta_lakowitziana;
Zotu91	Eukaryota;Bacillariophyta;Bacillariophyceae;Naviculales;Sellaphoraceae;Sellaphora_cf. seminulum;
Zotu92	Eukaryota;Rotifera;Eurotatoria;Ploima;Trichocercidae;Trichocerca_multicrinis;
Zotu93	Eukaryota;Bacillariophyta;Mediophyceae;Lithodesmiales;Lithodesmiaceae;Helicotheca_tamesis;
Zotu94	Eukaryota;Ochrophyta;Chrysophyceae;Chromulinales;Chromulinaceae;Pedospumella_spp.;
Zotu95	Eukaryota;Oomycota;Oomycetes;Saprolegniales;Saprolegniaceae;Achlya_sparrowii;
Zotu96	Eukaryota;Ochrophyta;Synurophyceae;Synurales;Mallomonadaceae;Synura_petersenii;
Zotu97	Eukaryota;Rotifera;Eurotatoria;Ploima;Brachionidae;Brachionus_spp.;
Zotu98	Eukaryota;Rotifera;Eurotatoria;Ploima;Synchaetidae;Polyarthra_spp.;
Zotu99	Eukaryota;Arthropoda;Hexanauplia;Calanoida;Pontellidae;unknown_copepod;
Zotu100	Eukaryota;Rotifera;Eurotatoria;Ploima;Trichocercidae;Trichocerca_spp.;
Zotu101	Eukaryota;Bacillariophyta;Coscinodiscophyceae;Melosirales;Melosiraceae;Melosira_ambiqua;
Zotu102	Eukaryota;Rotifera;Eurotatoria;Ploima;Trichocercidae;Trichocerca_spp.;
Zotu103	Eukaryota;Alveolata;Dinophyceae;unknown;unknown;unknown_dinoflagellate;
Zotu104	Eukaryota;Ochrophyta;Eustigmatophyceae;Eustigmatales;Monodopsidaceae;Nannochloropsis_limnetica;
Zotu105	Eukaryota;Arthropoda;Hexanauplia;Calanoida;Pontellidae;unknown_copepod;
Zotu107	Eukaryota;Rotifera;Eurotatoria;Ploima;Brachionidae;Keratella_cochlearis;
Zotu108	Eukaryota;Arthropoda;Hexanauplia;Calanoida;Diaptomidae;Leptodiaptomus_minutus;
Zotu109	Eukaryota;Ochrophyta;Raphidophyceae;Chattonellales;Chattonellaceae;Chattonella_marina;
Zotu111	Eukaryota;Bacillariophyta;Coscinodiscophyceae;Coscinodiscales;Coscinodiscaceae;Coscinodiscus_wailesii;
Zotu113	Eukaryota;Chlorophyta;Trebouxiophyceae;Trebouxiales;unknown;Botryococcus_braunii;
Zotu114	Eukaryota;Arthropoda;Insecta;Coleoptera;Staphylinidae;Quedius_obliqueseriatus;
Zotu116	Eukaryota;Rotifera;Eurotatoria;Flosculariaceae;Conochilidae;Conochilus_unicornis;
Zotu117	Eukaryota;Rotifera;Eurotatoria;Ploima;Gastropidae;Ascomorpha_spp.;
Zotu118	Eukaryota;Bacillariophyta;Coscinodiscophyceae;Melosirales;Melosiraceae;Melosira_ambiqua;
Zotu119	Eukaryota;Chlorophyta;Trebouxiophyceae;Trebouxiales;unknown;Botryococcus_braunii;
Zotu120	Eukaryota;Ochrophyta;Phaeophyceae;Ectocarpales;Scytosiphonaceae;Petalonia_tenella;
Zotu122	Eukaryota;Gastrotricha;Paucitubulatina ;Chaetonotida;Chaetonotidae;Chaetonotus_similis;
Zotu123	Bacteria;Pseudomonadota;Alphaproteobacteria;Rickettsiales;Rickettsiaceae;unknown_bacterium;
Zotu127	Eukaryota;Arthropoda;Hexanauplia;Calanoida;Pontellidae;unknown_copepod;
Zotu129	Eukaryota;Arthropoda;Insecta;Coleoptera;Staphylinidae;Quedius_obliqueseriatus;
Zotu130	Eukaryota;Rotifera;Eurotatoria;Ploima;Synchaetidae;Polyarthra_vulgaris;
Zotu134	Eukaryota;Ochrophyta;Chrysophyceae;Chromulinales;Dinobryaceae;Dinobryon_pediforme;
Zotu135	Eukaryota;Ochrophyta;Raphidophyceae;Chattonellales;Chattonellaceae;Chattonella_marina;
Zotu139	Eukaryota;Bacillariophyta;Bacillariophyceae;Naviculales;Amphipleuraceae;Frustulia_vulgaris;
Zotu140	Eukaryota;Ochrophyta;Phaeophyceae;Ectocarpales;Scytosiphonaceae;Petalonia_tenella;
Zotu141	Eukaryota;Chlorophyta;Chlorophyceae;Chlamydomonadales;unknown;Limnomonas_spitsbergensis;
Zotu142	Eukaryota;Ochrophyta;Chrysophyceae;Chromulinales;Dinobryaceae;Dinobryon_cylindricollarium;
Zotu144	Bacteria;Pseudomonadota;Betaproteobacteria;Nitrosomonadales;Nitrosomonadaceae;Nitrosomonas_ureae;
Zotu145	Eukaryota;Gastrotricha;Paucitubulatina ;Chaetonotida;Chaetonotidae;Chaetonotus_spp.;
Zotu147	Eukaryota;Ochrophyta;Chrysophyceae;Chromulinales;Dinobryaceae;Dinobryon_similis;
Zotu148	Eukaryota;Gastrotricha;Paucitubulatina ;Chaetonotida;Chaetonotidae;Aspidiophorus_ophiodermus;
Zotu149	Eukaryota;Arthropoda;Insecta;Diptera;Chironomidae;Tanytarsus_spp.;
Zotu151	Eukaryota;Ochrophyta;Raphidophyceae;Chattonellales;Chattonellaceae;Chattonella_marina;
Zotu152	Eukaryota;Rotifera;Eurotatoria;Ploima;Trichocercidae;Trichocerca_spp.;
Zotu153	Eukaryota;Gastrotricha;Paucitubulatina ;Chaetonotida;Chaetonotidae;Chaetonotus_iratus;
Zotu154	Eukaryota;Ochrophyta;Phaeophyceae;Ectocarpales;Chordariaceae;Laminarionema_elsbetiae;
Zotu156	Eukaryota;Ochrophyta;Phaeophyceae;Ectocarpales;Scytosiphonaceae;Manzaea_minuta;
Zotu157	Eukaryota;Rotifera;Eurotatoria;Ploima;Asplanchnidae;Asplanchna_spp.;
Zotu158	Eukaryota;Ochrophyta;Raphidophyceae;Chattonellales;Chattonellaceae;Chattonella_marina;
Zotu159	Bacteria;Bacteroidota;Bacteroidia;Bacteroidales;unknown;unknown_bacterium;
Zotu163	Eukaryota;Ochrophyta;Raphidophyceae;Chattonellales;Chattonellaceae;Chattonella_marina;
Zotu164	Eukaryota;Gastrotricha;Paucitubulatina ;Chaetonotida;Chaetonotidae;Chaetonotus_daphnes;
Zotu171	Eukaryota;Ochrophyta;Raphidophyceae;Chattonellales;Chattonellaceae;Chattonella_marina;
Zotu172	Eukaryota;Ochrophyta;Phaeophyceae;Ectocarpales;Chordariaceae;Nemacystus_decipiens;
Zotu174	Bacteria;Pseudomonadota;Alphaproteobacteria;Rickettsiales;Rickettsiaceae;unknown_bacterium;
Zotu175	Bacteria;Pseudomonadota;Alphaproteobacteria;Rickettsiales;Rickettsiaceae;unknown_bacterium;
Zotu176	Eukaryota;Ochrophyta;Chrysophyceae;Chromulinales;Dinobryaceae;Poteriospumella_;
Zotu178	Eukaryota;Alveolata;Dinophyceae;unknown;unknown;unknown_dinoflagellate;
Zotu181	Bacteria;Pseudomonadota;Alphaproteobacteria;Rickettsiales;Rickettsiaceae;unknown_bacterium;
Zotu183	Eukaryota;Oomycota;Oomycetes;Saprolegniales;Saprolegniaceae;Achlya_sparrowii;
Zotu184	Eukaryota;Rotifera;Eurotatoria;Ploima;Trichocercidae;Trichocerca_spp.;
Zotu185	Eukaryota;Ochrophyta;Chrysophyceae;Chromulinales;Chromulinaceae;Pedospumella_sinomuralis;
Zotu186	Eukaryota;Ochrophyta;Raphidophyceae;Chattonellales;Chattonellaceae;Chattonella_marina;
Zotu188	Eukaryota;Gastrotricha ;Paucitubulatina ;Chaetonotida;Chaetonotidae;Chaetonotus_persimilis;
Zotu189	Bacteria;Pseudomonadota;Alphaproteobacteria;Rickettsiales;Rickettsiaceae;unknown_bacterium;
Zotu190	Eukaryota;Rotifera;Eurotatoria;Ploima;Gastropidae;Ascomorpha_ovalis;
Zotu191	Eukaryota;Rotifera;Eurotatoria;Flosculariaceae;Conochilidae;Conochilus_unicornis;
Zotu194	Eukaryota;Ochrophyta;Phaeophyceae;Scytothamnales;Bachelotiaceae;Bachelotia_antillarum;
Zotu199	Eukaryota;Oomycota;Oomycetes;Peronosporales;Peronosporaceae;Phytophthora_ramorum;
Zotu200	Eukaryota;Rotifera;Eurotatoria;Flosculariaceae;Conochilidae;Conochilus_unicornis;
Zotu203	Eukaryota;Ochrophyta;Chrysophyceae;Chromulinales;Dinobryaceae;Poteriospumella_spp.;
Zotu204	Eukaryota;Chlorophyta;Trebouxiophyceae;Chlorellales;Chlorellaceae;Chlorella_dessicata ;
Zotu205	Eukaryota;Chlorophyta;Trebouxiophyceae;Chlorellales;Chlorellaceae;Chlorella_dessicata ;
Zotu206	Eukaryota;Rotifera;Eurotatoria;Ploima;Brachionidae;Keratella_cochlearis;
Zotu209	Eukaryota;Ochrophyta;Chrysophyceae;Chromulinales;Dinobryaceae;Dinobryon_cylindricollarium;
Zotu210	Eukaryota;Ochrophyta;Phaeophyceae;Ectocarpales;Acinetosporaceae;unknown_ochrophyte;
Zotu211	Eukaryota;Chlorophyta;Trebouxiophyceae;Trebouxiophyceae ordo;Coccomyxaceae;unknown_microalga;
Zotu213	Eukaryota;Arthropoda;Insecta;Hemiptera;Aphididae;Hyalomyzus_spp.;
Zotu214	Bacteria;Pseudomonadota;Betaproteobacteria;Nitrosomonadales;Methylophilaceae;Methylotenera_versatilis;
Zotu217	Eukaryota;Ascomycota;Leotiomycetes;Thelebolales;Thelebolaceae;Pseudogymnoascus_destructans;
Zotu219	Eukaryota;Ochrophyta;Bacillariophyceae;Naviculales;Sellaphoraceae;Sellaphora_seminulum;
Zotu220	Eukaryota;Chlorophyta;Chlorophyceae;Chlamydomonadales;Chlamydomonadaceae;Chlamydomonas_spp.;
Zotu221	Eukaryota;Arthropoda;Insecta;Diptera;Chironomidae;Tanytarsus_spp.;
Zotu222	Eukaryota;Ochrophyta;Chrysophyceae;Chromulinales;Dinobryaceae;Dinobryon_similis;
Zotu224	Bacteria;Pseudomonadota;Alphaproteobacteria;Rickettsiales;Rickettsiaceae;unknown_bacterium;
Zotu226	Eukaryota;Rotifera;Eurotatoria;Ploima;Brachionidae;Keratella_cochlearis;
Zotu227	Eukaryota;Rotifera;Eurotatoria;Ploima;Synchaetidae;Synchaeta_lakowitziana;
Zotu231	Eukaryota;Rotifera;Eurotatoria;Ploima;Trichocercidae;Trichocerca_spp.;
Zotu232	Bacteria;Pseudomonadota;Alphaproteobacteria;Rickettsiales;Rickettsiaceae;unknown_bacterium;
Zotu233	Eukaryota;Oomycota;Oomycetes;Peronosporales;Peronosporaceae;Phytophthora_ramorum;
Zotu234	Eukaryota;Rotifera;Eurotatoria;Ploima;Lecanidae;Lecane_closterocerca;
Zotu235	Bacteria;Pseudomonadota;Alphaproteobacteria;Rickettsiales;Rickettsiaceae;unknown_bacterium;
Zotu236	Eukaryota;Ochrophyta;Chrysophyceae;Chromulinales;Chromulinaceae;Pedospumella_spp.;
Zotu237	Eukaryota;Rotifera;Eurotatoria;Ploima;Synchaetidae;Polyarthra_dolichoptera;
Zotu238	Eukaryota;Rotifera;Eurotatoria;Ploima;Synchaetidae;Polyarthra_spp.;
Zotu240	Eukaryota;Rotifera;Eurotatoria;Ploima;Trichocercidae;Trichocerca_capucina;
Zotu244	Eukaryota;Rotifera;Eurotatoria;Ploima;Lecanidae;Lecane_spp.;
Zotu247	Eukaryota;Rotifera;Eurotatoria;Ploima;Gastropidae;Ascomorpha_spp.;
Zotu248	Eukaryota;Chlorophyta;Trebouxiophyceae;Trebouxiales;unknown;Choricystis_spp.;
Zotu251	Eukaryota;Ochrophyta;Coscinodiscophyceae;Melosirales;Melosiraceae;Melosira_ambiqua;
Zotu254	Eukaryota;Ochrophyta;Coscinodiscophyceae;Melosirales;Melosiraceae;Melosira_ambiqua;
Zotu255	Eukaryota;Ochrophyta;Coscinodiscophyceae;Melosirales;Melosiraceae;Melosira_ambiqua;
Zotu256	Eukaryota;Ochrophyta;Phaeophyceae;Scytothamnales;unknown;Stereocladon_rugulosus;
Zotu257	Eukaryota;Chlorophyta;Chlorophyceae;Chlamydomonadales;Chlamydomonadaceae;Chlamydomonas_spp.;
Zotu259	Eukaryota;Rotifera;Eurotatoria;Ploima;Gastropidae;Ascomorpha_spp.;
Zotu260	Eukaryota;Ochrophyta;Chrysophyceae;Chromulinales;Dinobryaceae;Dinobryon_cylindricollarium;
Zotu261	Eukaryota;Chlorophyta;Chlorophyceae;Chlamydomonadales;unknown;Limnomonas_spitsbergensis;
Zotu262	Eukaryota;Gastrotricha ;Paucitubulatina ;Chaetonotida;Chaetonotidae;Chaetonotus_spp.;
Zotu263	Eukaryota;Rotifera;Eurotatoria;Ploima;Synchaetidae;Synchaeta_spp.;
Zotu264	Eukaryota;Ochrophyta;Bacillariophyceae;Naviculales;Amphipleuraceae;Frustulia_vulgaris;
Zotu265	Eukaryota;Rotifera;Eurotatoria;Ploima;Brachionidae;Keratella_cochlearis;
Zotu266	Eukaryota;Rotifera;Eurotatoria;Ploima;Brachionidae;Keratella_crassa;
Zotu267	Bacteria;Pseudomonadota;Alphaproteobacteria;Rickettsiales;Rickettsiaceae;unknown_bacterium;
Zotu268	Eukaryota;Oomycota;Oomycetes;Pythiales;Pythiaceae;Elongisporangium_helicandrum;
Zotu271	Eukaryota;Oomycota;Oomycetes;Pythiales;Pythiaceae;Elongisporangium_helicandrum;
Zotu272	Eukaryota;Rotifera;Eurotatoria;Ploima;Synchaetidae;Polyarthra_vulgaris;
Zotu276	Eukaryota;Arthropoda;Branchiopoda;Diplostraca;Daphniidae;Daphnia_dubia;
Zotu277	Eukaryota;Ochrophyta;Chrysophyceae;unknown;unknown;unknown_chrysophytes;
Zotu278	Eukaryota;Ochrophyta;Phaeophyceae;Ectocarpales;Chordariaceae;Mesogloia_japonica;
Zotu279	Eukaryota;Chlorophyta;Trebouxiophyceae;Trebouxiophyceae ordo;Coccomyxaceae;unknown_microalga;
Zotu284	Eukaryota;Ochrophyta;Chrysophyceae;Chromulinales;Chromulinaceae;Pedospumella_sinomuralis;
Zotu286	Bacteria;Pseudomonadota;Alphaproteobacteria;Hyphomicrobiales;Phyllobacteriaceae;Phyllobacterium_;
Zotu287	Eukaryota;Ochrophyta;Fragilariophyceae;Fragilariales;Fragilariaceae;Asterionellopsis_guyunusae;
Zotu288	Eukaryota;Ochrophyta;Phaeophyceae;Laminariales;Laminariaceae;Saccharina_sessilis;
Zotu290	Eukaryota;Rotifera;Eurotatoria;Ploima;Trichocercidae;Trichocerca_spp.;
Zotu291	Eukaryota;Ochrophyta;Synurophyceae;Ochromonadales;Ochromonadaceae;Poterioochromonas_stipitata;
Zotu293	Eukaryota;Chlorophyta;Trebouxiophyceae;Chlorellales;Chlorellaceae;Chlorella_dessicata;
Zotu294	Eukaryota;Ochrophyta;Chrysophyceae;Chromulinales;Chromulinaceae;Pedospumella_sinomuralis;
Zotu296	Eukaryota;Ochrophyta;Chrysophyceae;Chromulinales;Dinobryaceae;Dinobryon_inclinatum;
Zotu297	Eukaryota;Ochrophyta;Phaeophyceae;Ectocarpales;Chordariaceae;unknown_ochrophyte;
Zotu298	Eukaryota;Arthropoda;Insecta;Diptera;Chironomidae;Tanytarsus_spp.;
Zotu299	Eukaryota;Rotifera;Eurotatoria;Ploima;Asplanchnidae;Asplanchna_spp.;
Zotu300	Eukaryota;Ochrophyta;Chrysophyceae;Chromulinales;Chromulinaceae;Pedospumella_spp.;
Zotu301	Eukaryota;Ochrophyta;Chrysophyceae;Chromulinales;Chromulinaceae;Pedospumella_sinomuralis;
Zotu302	Eukaryota;Rotifera;Eurotatoria;Ploima;Lecanidae;Lecane_leontina;
Zotu303	Eukaryota;Ochrophyta;Chrysophyceae;Chromulinales;Dinobryaceae;Dinobryon_exstoundulatum;
Zotu304	Eukaryota;Ochrophyta;Chrysoparadoxophyceae;Chrysoparadoxales;Chrysoparadoxaceae;Chrysoparadoxa_australica;
Zotu306	Eukaryota;Alveolata;Dinophyceae;unknown;unknown;unknown_dinoflagellate;
Zotu308	Eukaryota;Ochrophyta;Synurophyceae;Ochromonadales;Ochromonadaceae;Poterioochromonas_stipitata;
Zotu309	Eukaryota;Chlorophyta;Trebouxiophyceae;Chlorellales;Chlorellaceae;Chlorella_desiccata;
Zotu312	Eukaryota;Ochrophyta;Chrysophyceae;Chromulinales;Chromulinaceae;Pedospumella_sinomuralis;
Zotu313	Eukaryota;Rotifera;Eurotatoria;Ploima;Asplanchnidae;Asplanchna_spp.;
Zotu314	Bacteria;Pseudomonadota;Alphaproteobacteria;Rickettsiales;Anaplasmataceae;unknown_bacterium;
Zotu315	Eukaryota;Ochrophyta;Phaeophyceae;Ectocarpales;Chordariaceae;unknown_ochrophyte;
Zotu317	Eukaryota;Ochrophyta;Chrysophyceae;Chromulinales;Chromulinaceae;Pedospumella_sinomuralis;
Zotu318	Bacteria;Pseudomonadota;Betaproteobacteria;Nitrosomonadales;Methylophilaceae;Methylotenera_spp.;
Zotu320	Eukaryota;Chytridiomycota;Chytridiomycetes;Synchytriales;Synchytriaceae;Synchytrium_microbalum;
Zotu321	Eukaryota;Ochrophyta;Chrysophyceae;Chromulinales;Dinobryaceae;Dinobryon_similis;
Zotu322	Eukaryota;Ochrophyta;Chrysophyceae;Chromulinales;Chromulinaceae;Pedospumella_sinomuralis;
Zotu323	Eukaryota;Ochrophyta;Chrysophyceae;Chromulinales;Dinobryaceae;Dinobryon_exstoundulatum;
Zotu326	Eukaryota;Ochrophyta;Chrysophyceae;Chromulinales;Dinobryaceae;Dinobryon_cylindricollarium;
Zotu327	Eukaryota;Ochrophyta;Chrysophyceae;Chromulinales;Chromulinaceae;Pedospumella_spp.;
Zotu328	Eukaryota;Rotifera;Eurotatoria;Ploima;Gastropidae;Ascomorpha_ovalis ;
Zotu333	Eukaryota;Ochrophyta;Bacillariophyceae;Naviculales;Sellaphoraceae;Sellaphora_seminulum;
Zotu335	Eukaryota;Chytridiomycota;Monoblepharidomycetes;Monoblepharidales;Hyaloraphidiaceae;Hyaloraphidium_curvatum;
Zotu336	Eukaryota;Rotifera;Eurotatoria;Ploima;Synchaetidae;Synchaeta_tremula;
Zotu337	Eukaryota;Chlorophyta;Chlorophyceae;Chlamydomonadales;Chlamydomonadaceae;Chlamydomonas_spp.;
Zotu338	Eukaryota;Chlorophyta;Trebouxiophyceae;Trebouxiophyceae ordo;Coccomyxaceae;unknown_microalga;
Zotu339	Eukaryota;Ochrophyta;Chrysophyceae;Chromulinales;Chromulinaceae;Pedospumella_sinomuralis;
Zotu341	Eukaryota;Ochrophyta;Phaeophyceae;Laminariales;Laminariaceae;Saccharina_sessilis;
Zotu344	Eukaryota;Rotifera;Eurotatoria;Ploima;Lecanidae;Lecane_leontina;
Zotu345	Eukaryota;Ochrophyta;Chrysophyceae;Chromulinales;Chromulinaceae;Pedospumella_sinomuralis;
Zotu346	Eukaryota;Oomycota;Oomycetes;Peronosporales;Peronosporaceae;Phytophthora_intercalaris;
Zotu347	Eukaryota;Ochrophyta;Chrysophyceae;Chromulinales;Dinobryaceae;Dinobryon_similis;
Zotu349	Eukaryota;Rotifera;Eurotatoria;Ploima;Brachionidae;Keratella_cochlearis;
Zotu351	Eukaryota;Oomycota;Oomycetes;Peronosporales;Peronosporaceae;Phytophthora_intercalaris;
Zotu354	Eukaryota;Gastrotricha ;Paucitubulatina ;Chaetonotida;Chaetonotidae;Heterolepidoderma_;
Zotu357	Eukaryota;Chlorophyta;Pyramimonadophyceae;Pyramimonadales;Pyramimonadaceae;Cymbomonas_tetramitiformis;
Zotu358	Eukaryota;Ochrophyta;Eustigmatophyceae;Goniochloridales;Goniochloridaceae;Trachydiscus_minutus;
Zotu359	Eukaryota;Amoebozoa;Elardia;Arcellinida;Netzeliidae;Cucurbitella_mespiliformis;
Zotu360	Eukaryota;Rotifera;Eurotatoria;Ploima;Lecanidae;Lecane_leontina;
Zotu363	Eukaryota;Ochrophyta;Chrysophyceae;Chromulinales;Dinobryaceae;Dinobryon_exstoundulatum;
Zotu364	Eukaryota;Rotifera;Eurotatoria;Ploima;Brachionidae;Keratella_cochlearis;
Zotu367	Eukaryota;Rotifera;Eurotatoria;Ploima;Synchaetidae;Ploesoma_truncatum;
Zotu368	Eukaryota;Alveolata;Dinophyceae;unknown;unknown;unknown_dinoflagellate;
Zotu369	Eukaryota;Ochrophyta;Chrysophyceae;Chromulinales;Dinobryaceae;Dinobryon_cylindricollarium;
Zotu372	Eukaryota;Basidiomycota;Malasseziomycetes;Malasseziales;Malasseziaceae;Malassezia_arunalokei;
Zotu375	Bacteria;Pseudomonadota;Alphaproteobacteria;Rickettsiales;Rickettsiaceae;unknown_bacterium;
Zotu381	Eukaryota;Alveolata;Dinophyceae;unknown;unknown;unknown_dinoflagellate;
Zotu382	Eukaryota;Ochrophyta;Synurophyceae;Synurales;Mallomonadaceae;Synura_spp.;
Zotu383	Eukaryota;Ochrophyta;Chrysophyceae;Chromulinales;Dinobryaceae;Dinobryon_similis;
Zotu386	Eukaryota;Ochrophyta;Chrysophyceae;unknown;unknown;unknown_chrysophytes;
Zotu387	Eukaryota;Ochrophyta;Bacillariophyceae;Naviculales;Sellaphoraceae;Sellaphora_seminulum;
Zotu388	Eukaryota;Rotifera;Eurotatoria;Flosculariaceae;Conochilidae;Conochilus_unicornis;
Zotu390	Bacteria;Pseudomonadota;Alphaproteobacteria;Rhodospirillales;Azospirillaceae;Skermanella_pratensis;
Zotu392	Eukaryota;Ochrophyta;Bacillariophyceae;Naviculales;Sellaphoraceae;Sellaphora_seminulum;
Zotu393	Eukaryota;Ochrophyta;Chrysophyceae;Chromulinales;Dinobryaceae;Dinobryon_pediforme;
Zotu395	Eukaryota;Ochrophyta;Eustigmatophyceae;Eustigmatales;Monodopsidaceae;Nannochloropsis_limnetica;
Zotu396	Eukaryota;Gastrotricha ;Paucitubulatina ;Chaetonotida;Chaetonotidae;Chaetonotus_phagnophilus;
Zotu398	Eukaryota;Arthropoda;Insecta;Hemiptera;Aphididae;Hyalomyzus_spp.;
Zotu399	Eukaryota;Ochrophyta;Chrysophyceae;Chromulinales;Dinobryaceae;Dinobryon_balticum;
Zotu400	Eukaryota;Rotifera;Eurotatoria;Ploima;Lecanidae;Lecane_leontina;
Zotu402	Eukaryota;Chlorophyta;Mamiellophyceae;Monomastigales;Monomastigaceae;Monomastix_minuta;
Zotu403	Eukaryota;Alveolata;Dinophyceae;unknown;unknown;unknown_dinoflagellate;
Zotu405	Eukaryota;Ochrophyta;Chrysophyceae;Chromulinales;Chromulinaceae;Pedospumella_spp.;
Zotu406	Eukaryota;Ochrophyta;Phaeophyceae;Ectocarpales;Scytosiphonaceae;Colpomenia_sinuosa;
Zotu410	Eukaryota;Ochrophyta;Bacillariophyceae;Naviculales;Sellaphoraceae;Sellaphora_seminulum;
Zotu411	Eukaryota;Oomycota;Oomycetes;Saprolegniales;Saprolegniaceae;Achlya_flagellata;
Zotu412	Eukaryota;Chlorophyta;Trebouxiophyceae;Chlorellales;Chlorellaceae;Marvania_coccoides;
Zotu413	Eukaryota;Rotifera;Eurotatoria;Ploima;Asplanchnidae;Asplanchna_spp.;
Zotu416	Eukaryota;Ochrophyta;Synurophyceae;Synurales;Mallomonadaceae;Mallomonas_;
Zotu417	Eukaryota;Ochrophyta;Chrysophyceae;Chromulinales;Chromulinaceae;Pedospumella_spp.;
Zotu418	Bacteria;Pseudomonadota;Alphaproteobacteria;Rickettsiales;Rickettsiaceae;Rickettsia_bellii;
Zotu420	Eukaryota;Ochrophyta;Phaeophyceae;Ectocarpales;Chordariaceae;Myrionema_balticum;
Zotu421	Eukaryota;Rotifera;Eurotatoria;Ploima;Brachionidae;Brachionus_spp.;
Zotu424	Eukaryota;Chlorophyta;Chlorophyceae;Sphaeropleales;Scenedesmaceae;Scenedesmus_quadricauda;
Zotu425	Eukaryota;Ascomycota;Dothideomycetes;Mycosphaerellales;Mycosphaerellaceae;Cercospora_sojina;
Zotu427	Eukaryota;Rotifera;Eurotatoria;Ploima;Brachionidae;Keratella_spp.;
Zotu428	Eukaryota;Chlorophyta;Chlorophyceae;Chlamydomonadales;unknown;Limnomonas_spitsbergensis;
Zotu429	Eukaryota;Chlorophyta;Trebouxiophyceae;Trebouxiales;unknown;Choricystis_spp.;
Zotu430	Eukaryota;Ochrophyta;Phaeophyceae;Ectocarpales;Ectocarpaceae;Ectocarpus_siliculosus;
Zotu431	Eukaryota;Ochrophyta;Chrysophyceae;Chromulinales;Dinobryaceae;Dinobryon_cylindricollarium;
Zotu432	Eukaryota;Ochrophyta;Chrysophyceae;Chromulinales;Dinobryaceae;Dinobryon_taiyuanensis;
Zotu436	Eukaryota;Rotifera;Eurotatoria;Ploima;Synchaetidae;Synchaeta_pectinata;
Zotu437	Eukaryota;Ochrophyta;Coscinodiscophyceae;Melosirales;Melosiraceae;Melosira_ambiqua;
Zotu438	Eukaryota;Ochrophyta;Chrysophyceae;Chromulinales;Chromulinaceae;Pedospumella_sinomuralis;
Zotu439	Eukaryota;Alveolata;Dinophyceae;unknown;unknown;unknown_dinoflagellate;
Zotu440	Eukaryota;Oomycota;Oomycetes;Longamoebia;Acanthamoebidae;Acanthamoeba_spp.;
Zotu441	Eukaryota;Rotifera;Eurotatoria;Ploima;Trichocercidae;Trichocerca_spp.;
Zotu443	Eukaryota;Oomycota;Oomycetes;Peronosporales;Peronosporaceae;Nothophytophthora_caduca;
Zotu444	Eukaryota;Oomycota;Oomycetes;Saprolegniales;Saprolegniaceae;Saprolegnia_turfosa;
Zotu448	Eukaryota;Oomycota;Oomycetes;Peronosporales;Peronosporaceae;Phytophthora_bishii;
Zotu453	Eukaryota;Rotifera;Eurotatoria;Ploima;Asplanchnidae;Asplanchna_spp.;
Zotu454	Eukaryota;Mucoromycota;Mucoromycetes;Mucorales;Mucoraceae;Mucor_piriformis;
Zotu455	Bacteria;Pseudomonadota;Alphaproteobacteria;Rhodospirillales;Rhodospirillaceae;Magnetospirillum_;
Zotu456	Eukaryota;Ochrophyta;Chrysophyceae;Chromulinales;Dinobryaceae;Dinobryon_cylindricollarium;
Zotu458	Eukaryota;Rotifera;Eurotatoria;Ploima;Synchaetidae;Polyarthra_spp.;
Zotu459	Eukaryota;Ochrophyta;Chrysophyceae;Chromulinales;Chromulinaceae;Pedospumella_sinomuralis;
Zotu460	Eukaryota;Alveolata;Dinophyceae;Thoracosphaerales;Thoracosphaeraceae;Thoracosphaera_spp.;
Zotu461	Eukaryota;Alveolata;Dinophyceae;unknown;unknown;unknown_dinoflagellate;
Zotu464	Eukaryota;Ochrophyta;Chrysophyceae;Chromulinales;Dinobryaceae;Dinobryon_similis;
Zotu467	Eukaryota;Chlorophyta;Trebouxiophyceae;Trebouxiales;unknown;Choricystis_spp.;
Zotu470	Eukaryota;Oomycota;Oomycetes;Himatismenida;Cochliopodiidae;Ovalopodium_rosalinum;
Zotu472	Eukaryota;Rotifera;Eurotatoria;Flosculariaceae;Conochilidae;Conochilus_unicornis;
Zotu474	Eukaryota;Ochrophyta;Chrysophyceae;Chromulinales;Dinobryaceae;Dinobryon_pediforme;
Zotu475	Eukaryota;Gastrotricha ;Paucitubulatina ;Chaetonotida;Chaetonotidae;Chaetonotus_spp.;
Zotu477	Eukaryota;Ochrophyta;Chrysophyceae;Chromulinales;Dinobryaceae;Dinobryon_cylindricollarium;
Zotu482	Eukaryota;Gastrotricha ;Paucitubulatina ;Chaetonotida;Chaetonotidae;Chaetonotus_spp.;
Zotu483	Eukaryota;Arthropoda;Insecta;Diptera;Chironomidae;Tanytarsus_spp.;
Zotu485	Eukaryota;Ochrophyta;Chrysophyceae;Chromulinales;Dinobryaceae;Dinobryon_cylindricum;
Zotu490	Eukaryota;Arthropoda;Insecta;Diptera;Mycetophilidae;unknown_mycetophilide;
Zotu493	Bacteria;Pseudomonadota;Alphaproteobacteria;Rickettsiales;Rickettsiaceae;unknown_bacterium;
Zotu494	Eukaryota;Oomycota;Oomycetes;Haptoglossales;Haptoglossaceae;Haptoglossa_spp.;
Zotu495	Eukaryota;Amoebozoa;Discosea;Vannellida;Vannellidae;Ripella_tribonemae;
Zotu496	Eukaryota;Ochrophyta;Chrysophyceae;Chromulinales;Dinobryaceae;Dinobryon_sertularia;
Zotu497	Eukaryota;Ochrophyta;Coscinodiscophyceae;Coscinodiscales;Coscinodiscaceae;Coscinodiscus_wailesii;
Zotu499	Eukaryota;Ochrophyta;Phaeophyceae;Ectocarpales;Scytosiphonaceae;Colpomenia_sinuosa;
Zotu500	Eukaryota;Ochrophyta;Chrysophyceae;Chromulinales;Dinobryaceae;Dinobryon_similis;
Zotu501	Eukaryota;Ascomycota;Sordariomycetes;Hypocreales;Stachybotryaceae;Myrothecium_inundatum;
Zotu502	Eukaryota;Ochrophyta;Bacillariophyceae;Naviculales;Sellaphoraceae;Sellaphora_seminulum;
Zotu503	Eukaryota;Rotifera;Eurotatoria;Ploima;Trichocercidae;Trichocerca_stylata;
Zotu506	Eukaryota;Ochrophyta;Phaeophyceae;Ectocarpales;Acinetosporaceae;unknown_ochrophyte;
Zotu508	Eukaryota;Ochrophyta;Coscinodiscophyceae;Melosirales;Melosiraceae;Melosira_ambiqua;
Zotu510	Eukaryota;Ochrophyta;Xanthophyceae;Mischococcales;Mischococcaceae;Mischococcus_sphaerocephalus;
Zotu511	Eukaryota;Chlorophyta;Chlorophyceae;Chlamydomonadales;unknown;Limnomonas_spitsbergensis;
Zotu512	Eukaryota;Ochrophyta;Synurophyceae;Synurales;Mallomonadaceae;Synura_spp.;
Zotu515	Eukaryota;Ochrophyta;Synurophyceae;Synurales;Mallomonadaceae;Synura_spp.;
Zotu516	Eukaryota;Ochrophyta;Bacillariophyceae;Naviculales;Sellaphoraceae;Sellaphora_seminulum;
Zotu517	Eukaryota;Ochrophyta;Chrysophyceae;Chromulinales;Chromulinaceae;Pedospumella_spp.;
Zotu518	Eukaryota;Ochrophyta;Synurophyceae;Synurales;Mallomonadaceae;Mallomonas_spp.;
Zotu521	Eukaryota;Annelida;Clitellata;Tubificida;Naididae;Ilyodrilus_templetoni;
Zotu522	Eukaryota;Gastrotricha ;Paucitubulatina ;Chaetonotida;Chaetonotidae;Chaetonotus_borealis;
Zotu523	Eukaryota;Ochrophyta;Synurophyceae;Synurales;Mallomonadaceae;Mallomonas_spp.;
Zotu527	Eukaryota;Oomycota;Oomycetes;Longamoebia;Acanthamoebidae;Acanthamoeba_comandoni;
Zotu528	Eukaryota;Ochrophyta;Chrysophyceae;Chromulinales;Chromulinaceae;Pedospumella_sinomuralis;
Zotu529	Eukaryota;Ochrophyta;Chrysophyceae;Chromulinales;Chromulinaceae;Pedospumella_spp.;
Zotu530	Eukaryota;Alveolata;Dinophyceae;unknown;unknown;unknown_dinoflagellate;
Zotu531	Eukaryota;Arthropoda;Arachnida;unknown;unknown;unknown_arachnide;
Zotu532	Eukaryota;Rotifera;Eurotatoria;Ploima;Brachionidae;Keratella_cochlearis;
Zotu533	Eukaryota;Ochrophyta;Phaeophyceae;Ectocarpales;Scytosiphonaceae;Petalonia_fascia;
Zotu535	Eukaryota;Ochrophyta;Synurophyceae;Ochromonadales;Ochromonadaceae;Poterioochromonas_stipitata;
Zotu540	Eukaryota;Amoebozoa;Flabellinia;Dactylopodida;Vexilliferidae;Vexillifera_kereti;
Zotu542	Eukaryota;Ochrophyta;Synurophyceae;Ochromonadales;Ochromonadaceae;Cornospumella_fuschlensis;
Zotu544	Eukaryota;Alveolata;Dinophyceae;Peridiniales;Pfiesteriaceae;unknown_dinoflagellate;
Zotu546	Eukaryota;Ochrophyta;Chrysophyceae;Chromulinales;Dinobryaceae;Dinobryon_balticum;
Zotu547	Eukaryota;Rotifera;Eurotatoria;Ploima;Brachionidae;Brachionus_spp.;
Zotu548	Eukaryota;Ochrophyta;Raphidophyceae;unknown;unknown;Haramonas_dimorpha;
Zotu549	Eukaryota;Ochrophyta;Eustigmatophyceae;Eustigmatales;Monodopsidaceae;Nannochloropsis_limnetica;
Zotu550	Eukaryota;Arthropoda;Arachnida;Araneae;Idiopidae;Idiosoma_sigillatum;
Zotu551	Eukaryota;Ochrophyta;Chrysophyceae;Chromulinales;Dinobryaceae;Dinobryon_sertularia;
Zotu553	Eukaryota;Ochrophyta;Chrysophyceae;Chromulinales;Chromulinaceae;Pedospumella_spp.;
Zotu554	Eukaryota;Ochrophyta;Phaeophyceae;Ectocarpales;Acinetosporaceae;unknown_ochrophyte;
Zotu557	Eukaryota;Chlorophyta;Chlorophyceae;Sphaeropleales;Scenedesmaceae;Scenedesmus_quadricauda;
Zotu558	Eukaryota;Oomycota;Oomycetes;Saprolegniales;Saprolegniaceae;Achlya_sparrowii;
Zotu560	Eukaryota;Ochrophyta;Chrysophyceae;Chromulinales;Dinobryaceae;Dinobryon_cylindricollarium;
Zotu561	Eukaryota;Alveolata;Dinophyceae;unknown;unknown;unknown_dinoflagellate;
Zotu562	Eukaryota;Entomophthoromycota;Entomophthoromycetes;Entomophthorales;Ancylistaceae;Conidiobolus_mycophagus;
Zotu563	Eukaryota;Ochrophyta;Chrysophyceae;unknown;unknown;unknown_chrysophytes;
Zotu564	Eukaryota;Oomycota;Oomycetes;Peronosporales;Peronosporaceae;Sisuluriver_spp.;
Zotu565	Eukaryota;Ochrophyta;Phaeophyceae;Ectocarpales;Chordariaceae;unknown_ochrophyte;
Zotu566	Eukaryota;Chytridiomycota;Chytridiomycetes;Synchytriales;Synchytriaceae;Synchytrium_microbalum;
Zotu567	Eukaryota;Rotifera;Eurotatoria;Ploima;Synchaetidae;Synchaeta_gyrina;
Zotu568	Eukaryota;Ochrophyta;Eustigmatophyceae;Eustigmatales;Monodopsidaceae;Nannochloropsis_limnetica;
Zotu569	Eukaryota;Ochrophyta;Raphidophyceae;Chattonellales;Chattonellaceae;Chattonella_marina;
Zotu570	Eukaryota;Rotifera;Eurotatoria;Ploima;Brachionidae;Keratella_cochlearis;
Zotu571	Eukaryota;Alveolata;Dinophyceae;unknown;unknown;unknown_dinoflagellate;
Zotu572	Eukaryota;Ochrophyta;Coscinodiscophyceae;Stephanodiscales;Stephanodiscaceae;Discostella_spp.;
Zotu574	Eukaryota;Amoebozoa;Elardia;Arcellinida;Netzeliidae;Cucurbitella_mespiliformis;
Zotu575	Eukaryota;Ochrophyta;Chrysophyceae;Chromulinales;Paraphysomonadaceae;Paraphysomonas_spp.;
Zotu576	Eukaryota;Ochrophyta;Chrysophyceae;Chromulinales;Dinobryaceae;Dinobryon_similis;
Zotu579	Eukaryota;Amoebozoa;Elardia;Euamoebida;unknown;Copromyxa_protea;
Zotu580	Eukaryota;Ascomycota;Eurotiomycetes;Eurotiales;Aspergillaceae;Penicillium_digitatum;
Zotu582	Eukaryota;Alveolata;Dinophyceae;unknown;unknown;unknown_dinoflagellate;
Zotu583	Eukaryota;Arthropoda;Hexanauplia;Calanoida;Diaptomidae;Leptodiaptomus_minutus;
Zotu584	Eukaryota;Oomycota;Oomycetes;Peronosporales;Peronosporaceae;Phytophthora_ohioensis ;
Zotu586	Eukaryota;Ochrophyta;Bacillariophyceae;Naviculales;Sellaphoraceae;Sellaphora_seminulum;
Zotu589	Eukaryota;Rotifera;Eurotatoria;Ploima;Gastropidae;Ascomorpha_ovalis;
Zotu591	Eukaryota;Rotifera;Eurotatoria;unknown;unknown;Rotaria_macrura;
Zotu592	Eukaryota;Rotifera;Eurotatoria;Ploima;Notommatidae;Cephalodella_binoculata;
Zotu593	Eukaryota;Oomycota;Oomycetes;Peronosporales;Peronosporaceae;Phytophthora_polonica;
Zotu595	Eukaryota;Rotifera;Eurotatoria;Ploima;Asplanchnidae;Asplanchna_sieboldi;
Zotu596	Eukaryota;Ochrophyta;Chrysophyceae;Chromulinales;Dinobryaceae;Dinobryon_cylindricollarium;
Zotu599	Eukaryota;Ochrophyta;Chrysophyceae;Chromulinales;Chromulinaceae;Pedospumella_sinomuralis;
Zotu600	Eukaryota;Ochrophyta;Phaeophyceae;Ectocarpales;Chordariaceae;unknown_ochrophyte;
Zotu602	Eukaryota;Ochrophyta;Chrysophyceae;Chromulinales;Chromulinaceae;Pedospumella_sinomuralis;
Zotu603	Eukaryota;Ochrophyta;Bacillariophyceae;Naviculales;Sellaphoraceae;Sellaphora_cf. seminulum;
Zotu604	Eukaryota;Ochrophyta;Phaeophyceae;Ectocarpales;Scytosiphonaceae;Petalonia_fascia;
Zotu606	Eukaryota;Ochrophyta;Dictyochophyceae;Florenciellales;unknown;Florenciella_parvula;
Zotu608	Eukaryota;Oomycota;Oomycetes;Longamoebia;Acanthamoebidae;Acanthamoeba_comandoni;
Zotu610	Eukaryota;Ascomycota;Sordariomycetes;Ophiostomatales;Ophiostomataceae;Ophiostoma_piceae;
Zotu611	Eukaryota;Rotifera;Eurotatoria;Ploima;Brachionidae;Brachionus_spp.;
Zotu612	Eukaryota;Ochrophyta;Chrysophyceae;Chromulinales;Dinobryaceae;Poteriospumella_lacustris;
Zotu614	Eukaryota;Ochrophyta;Eustigmatophyceae;Eustigmatales;Monodopsidaceae;Nannochloropsis_limnetica;
Zotu615	Eukaryota;Arthropoda;Insecta;Diptera;Chironomidae;Tanytarsus_spp.;
Zotu619	Eukaryota;Chlorophyta;Trebouxiophyceae;Chlorellales;Chlorellaceae;Chlorella_dessicata;
Zotu622	Eukaryota;Ochrophyta;Chrysophyceae;Chromulinales;Dinobryaceae;Dinobryon_cylindricollarium;
Zotu624	Eukaryota;Chytridiomycota;Chytridiomycetes;Synchytriales;Synchytriaceae;Synchytrium_endobioticum;
Zotu626	Eukaryota;Ochrophyta;Synurophyceae;Ochromonadales;Ochromonadaceae;Poterioochromonas_stipitata;
Zotu628	Eukaryota;Ochrophyta;Chrysophyceae;Chromulinales;Chromulinaceae;Pedospumella_sinomuralis;
Zotu632	Eukaryota;Ochrophyta;Synurophyceae;Synurales;Mallomonadaceae;Synura_petersenii;
Zotu633	Eukaryota;Rotifera;Eurotatoria;Ploima;Brachionidae;Kellicottia_bostoniensis;
Zotu637	Eukaryota;Oomycota;Oomycetes;Peronosporales;Peronosporaceae;Phytophthora_elongata;
Zotu638	Eukaryota;Ochrophyta;Phaeophyceae;Laminariales;Lessoniaceae;Eisenia_nipponica;
Zotu639	Eukaryota;Ochrophyta;Chrysophyceae;Chromulinales;Chromulinaceae;Pedospumella_sinomuralis;
Zotu640	Eukaryota;Alveolata;Dinophyceae;unknown;unknown;unknown_dinoflagellate;
Zotu643	Eukaryota;Oomycota;Oomycetes;Longamoebia;Acanthamoebidae;Acanthamoeba_spp.;
Zotu644	Eukaryota;Ochrophyta;Chrysophyceae;Chromulinales;Chromulinaceae;Pedospumella_sinomuralis;
Zotu647	Eukaryota;Ochrophyta;Synurophyceae;Ochromonadales;Ochromonadaceae;Cornospumella_fuschlensis;
Zotu648	Eukaryota;Ochrophyta;Chrysophyceae;Chromulinales;Chromulinaceae;Pedospumella_spp.;
Zotu649	Eukaryota;Oomycota;Oomycetes;Peronosporales;Peronosporaceae;Phytophthora_elongata;
Zotu650	Eukaryota;Oomycota;Oomycetes;Peronosporales;Peronosporaceae;Phytophthora_taiwanensis;
Zotu652	Eukaryota;Ochrophyta;Bacillariophyceae;Naviculales;Naviculaceae;Navicula_minima;
Zotu653	Eukaryota;Rotifera;Eurotatoria;Ploima;Trichocercidae;Trichocerca_stylata;
Zotu654	Eukaryota;Ochrophyta;Chrysophyceae;Chromulinales;Chromulinaceae;Pedospumella_spp.;
Zotu655	Eukaryota;Ochrophyta;Chrysophyceae;Chromulinales;Chromulinaceae;Pedospumella_sinomuralis;
Zotu657	Eukaryota;Oomycota;Oomycetes;Pythiales;Pythiaceae;Pythium_pachycaule;
Zotu658	Eukaryota;Chlorophyta;Chlorophyceae;Chlamydomonadales;Chlamydomonadaceae;Chlamydomonas_spp.;
Zotu659	Eukaryota;Gastrotricha ;Paucitubulatina ;Chaetonotida;Chaetonotidae;Chaetonotus_spp.;
Zotu660	Bacteria;Pseudomonadota;Alphaproteobacteria;Rickettsiales;Rickettsiaceae;unknown_bacterium;
Zotu661	Eukaryota;Ochrophyta;Chrysophyceae;Chromulinales;Chromulinaceae;Pedospumella_sinomuralis;
Zotu662	Eukaryota;Ochrophyta;Phaeophyceae;Ectocarpales;Scytosiphonaceae;Scytosiphon_lomentaria;
Zotu665	Eukaryota;Rotifera;Eurotatoria;Ploima;Lecanidae;Lecane_leontina;
Zotu667	Eukaryota;Arthropoda;Insecta;Diptera;Chironomidae;Tanytarsus_mendax;
Zotu668	Eukaryota;Alveolata;Dinophyceae;Suessiales;Suessiaceae;unknown_dinoflagellate;
Zotu669	Eukaryota;Basidiomycota;Agaricomycetes;Agaricales;Entolomataceae;Entoloma_clypeatum;
Zotu670	Eukaryota;Rotifera;Eurotatoria;Ploima;Notommatidae;Cephalodella_binoculata;
Zotu672	Eukaryota;Ochrophyta;Chrysophyceae;Chromulinales;Dinobryaceae;Dinobryon_cylindricollarium;
Zotu674	Eukaryota;Ochrophyta;Bacillariophyceae;Naviculales;Sellaphoraceae;Sellaphora_seminulum;
Zotu675	Eukaryota;Ascomycota;Eurotiomycetes;Eurotiales;Aspergillaceae;Penicillium_digitatum;
Zotu676	Eukaryota;Apicomplexa;Conoidasida;Eucoccidiorida;Lankesterellidae;Lankesterella_spp.;
Zotu677	Eukaryota;Ochrophyta;Chrysophyceae;Chromulinales;Dinobryaceae;Dinobryon_cylindricum;
Zotu678	Eukaryota;Ochrophyta;Chrysophyceae;Chromulinales;Dinobryaceae;Dinobryon_cylindricum;
Zotu679	Eukaryota;Ochrophyta;Synurophyceae;Synurales;Mallomonadaceae;Synura_synuroidea;
Zotu680	Eukaryota;Ochrophyta;Bacillariophyceae;Naviculales;Sellaphoraceae;Sellaphora_seminulum;
Zotu681	Eukaryota;Ochrophyta;Phaeophyceae;Ectocarpales;Scytosiphonaceae;Scytosiphon_lomentaria;
Zotu682	Eukaryota;Ochrophyta;Raphidophyceae;Actinophryida;Actinophryidae;Actinophrys_sol;
Zotu683	Eukaryota;Ochrophyta;Phaeophyceae;Ectocarpales;Chordariaceae;Chordaria_chordaeformis;
Zotu684	Eukaryota;Rotifera;Eurotatoria;Ploima;Trichocercidae;Trichocerca_spp.;
Zotu685	Eukaryota;Ochrophyta;Chrysophyceae;Chromulinales;Chromulinaceae;Pedospumella_spp.;
Zotu686	Eukaryota;Ochrophyta;Bacillariophyceae;Naviculales;Sellaphoraceae;Sellaphora_seminulum;
Zotu688	Eukaryota;Ascomycota;Sordariomycetes;Hypocreales;Stachybotryaceae;Myrothecium_inundatum;
Zotu690	Eukaryota;Oomycota;Oomycetes;Peronosporales;Peronosporaceae;Phytophthora_multiplex;
Zotu692	Eukaryota;Ochrophyta;Synurophyceae;Synurales;Mallomonadaceae;Synura_sphagnicola;
Zotu693	Eukaryota;Ochrophyta;Chrysophyceae;Chromulinales;Chromulinaceae;Pedospumella_sinomuralis;
Zotu694	Eukaryota;Chlorophyta;Trebouxiophyceae;Chlorellales;Chlorellaceae;Chlorella_dessicata;
Zotu697	Eukaryota;Ochrophyta;Synurophyceae;Ochromonadales;Ochromonadaceae;Poterioochromonas_stipitata;
Zotu698	Eukaryota;Rotifera;Eurotatoria;Ploima;Lecanidae;Lecane_leontina;
Zotu699	Eukaryota;Oomycota;Oomycetes;Himatismenida;Cochliopodiidae;Ovalopodium_rosalinum;
Zotu701	Eukaryota;Ochrophyta;Chrysophyceae;Chromulinales;Dinobryaceae;Dinobryon_cylindricollarium;
Zotu702	Eukaryota;Ochrophyta;Phaeophyceae;Ectocarpales;Chordariaceae;Leptonematella_fasciculata;
Zotu704	Eukaryota;Ochrophyta;Chrysophyceae;Chromulinales;Dinobryaceae;Dinobryon_cylindricum;
Zotu707	Eukaryota;Ochrophyta;Eustigmatophyceae;Eustigmatales;Monodopsidaceae;Nannochloropsis_limnetica;
Zotu708	Eukaryota;Oomycota;Oomycetes;Longamoebia;Acanthamoebidae;Acanthamoeba_spp.;
Zotu709	Eukaryota;Ochrophyta;Synurophyceae;Ochromonadales;Ochromonadaceae;Poterioochromonas_malhamensis;
Zotu710	Eukaryota;Ascomycota;Sordariomycetes;Diaporthales;Diaporthaceae;Diaporthe_spp.;
Zotu712	Eukaryota;Rotifera;Eurotatoria;Ploima;Brachionidae;Keratella_cochlearis;
Zotu713	Bacteria;Pseudomonadota;Betaproteobacteria;Nitrosomonadales;Methylophilaceae;Methylotenera_versatilis;
Zotu714	Eukaryota;Chlorophyta;Trebouxiophyceae;Chlorellales;Chlorellaceae;Chlorella_dessicata;
Zotu716	Eukaryota;Chytridiomycota;Chytridiomycetes;Synchytriales;Synchytriaceae;Synchytrium_microbalum;
Zotu719	Eukaryota;Alveolata;Dinophyceae;unknown;unknown;unknown_dinoflagellate;
Zotu720	Eukaryota;Oomycota;Oomycetes;Peronosporales;Peronosporaceae;Phytophthora_borneensis;
Zotu721	Eukaryota;Arthropoda;Hexanauplia;Calanoida;Pontellidae;unknown_copepod;
Zotu722	Eukaryota;Ochrophyta;Phaeophyceae;Ectocarpales;Chordariaceae;unknown_ochrophyte;
Zotu723	Eukaryota;Ochrophyta;Chrysophyceae;unknown;unknown;unknown_chrysophytes;
Zotu724	Eukaryota;Arthropoda;Branchiopoda;Diplostraca;Daphniidae;Daphnia_laevis;
Zotu728	Eukaryota;Ochrophyta;Bacillariophyceae;Naviculales;Sellaphoraceae;Sellaphora_minima;
Zotu731	Eukaryota;Ochrophyta;Chrysophyceae;Chromulinales;Dinobryaceae;Dinobryon_inclinatum;
Zotu732	Eukaryota;Alveolata;Dinophyceae;unknown;unknown;unknown_dinoflagellate;
Zotu733	Bacteria;Pseudomonadota;Betaproteobacteria;Nitrosomonadales;Methylophilaceae;Methylotenera_spp.;
Zotu734	Eukaryota;Rhodophyta;Bangiophyceae;Bangiales;Bangiaceae;Neoporphyra_haitanensis;
Zotu735	Eukaryota;Oomycota;Oomycetes;unknown;unknown;unknown_oomycetes;
Zotu739	Eukaryota;Ochrophyta;Chrysophyceae;Chromulinales;Chromulinaceae;Pedospumella_sinomuralis;
Zotu740	Eukaryota;Ochrophyta;Phaeophyceae;Tilopteridales;Phyllariaceae;Saccorhiza_polyschides;
Zotu741	Eukaryota;Amoebozoa;Flabellinia;Vannellida;Vannellidae;Vannella_salarenaria;
Zotu742	Eukaryota;Ochrophyta;Phaeophyceae;Ectocarpales;Acinetosporaceae;unknown_ochrophyte;
Zotu743	Eukaryota;Ochrophyta;Chrysophyceae;Chromulinales;Chromulinaceae;Pedospumella_sinomuralis;
Zotu744	Eukaryota;Rhodophyta;Florideophyceae;Peyssonneliales;Peyssonneliaceae ;Peyssonneliopsis_spp.;
Zotu747	Eukaryota;Ochrophyta;Bacillariophyceae;Naviculales;Amphipleuraceae;Frustulia_vulgaris;
Zotu748	Eukaryota;Ochrophyta;Bacillariophyceae;Naviculales;Pinnulariaceae;Pinnularia_acidicola;
Zotu750	Eukaryota;Ochrophyta;Chrysophyceae;Chromulinales;Dinobryaceae;Dinobryon_inclinatum;
Zotu751	Eukaryota;Ochrophyta;Chrysophyceae;Chromulinales;Dinobryaceae;Dinobryon_sertularia;
Zotu752	Eukaryota;Ochrophyta;Phaeophyceae;Dictyotales;Dictyotaceae;Dictyotopsis_propagulifera;
Zotu753	Eukaryota;Oomycota;Oomycetes;Longamoebia;Acanthamoebidae;Acanthamoeba_palestinensis;
Zotu754	Eukaryota;Ochrophyta;Synurophyceae;Synurales;Mallomonadaceae;Synura_sphagnicola;
Zotu755	Eukaryota;Ochrophyta;Eustigmatophyceae;Goniochloridales;Goniochloridaceae;Trachydiscus_minutus;
Zotu756	Eukaryota;Cnidaria;Hydrozoa;Leptothecata;Clytiidae;Clytia_spp.;
Zotu757	Eukaryota;Mucoromycota;Mucoromycetes;Mucorales;Mucoraceae;Mucor_piriformis;
Zotu758	Eukaryota;Ochrophyta;Phaeophyceae;Ectocarpales;Chordariaceae;unknown_ochrophyte;
Zotu760	Bacteria;Pseudomonadota;Betaproteobacteria;Nitrosomonadales;Methylophilaceae;Methylotenera_versatilis;
Zotu761	Eukaryota;Ochrophyta;Phaeophyceae;Ectocarpales;Acinetosporaceae;Acinetospora_asiatica;
Zotu762	Eukaryota;Ochrophyta;Synurophyceae;Synurales;Mallomonadaceae;Synura_petersenii;
Zotu764	Eukaryota;Porifera;Demospongiae;Haplosclerida;Niphatidae;unknown_poriferan;
Zotu765	Eukaryota;Rotifera;Eurotatoria;Ploima;Brachionidae;Euchlanis_dilatata;
Zotu766	Eukaryota;Ochrophyta;Synurophyceae;Synurales;Mallomonadaceae;Synura_petersenii;
Zotu767	Eukaryota;Chlorophyta;Trebouxiophyceae;Trebouxiales;Trebouxiaceae;Trebouxia_aggregata;
Zotu768	Eukaryota;Ochrophyta;Chrysophyceae;Chromulinales;Chromulinaceae;Pedospumella_sinomuralis;
Zotu769	Eukaryota;Alveolata;Dinophyceae;unknown;unknown;unknown_dinoflagellate;
Zotu772	Eukaryota;Chytridiomycota;Chytridiomycetes;Synchytriales;Synchytriaceae;Synchytrium_microbalum;
Zotu774	Eukaryota;Ochrophyta;Chrysophyceae;Chromulinales;Dinobryaceae;Dinobryon_similis;
Zotu775	Eukaryota;Arthropoda;Branchiopoda;Diplostraca;Holopediidae;Holopedium_glacialis;
Zotu776	Eukaryota;Ochrophyta;Phaeophyceae;Ectocarpales;Ectocarpaceae;Ectocarpus_siliculosus;
Zotu777	Eukaryota;Ochrophyta;Eustigmatophyceae;Eustigmatales;Monodopsidaceae;Nannochloropsis_limnetica;
Zotu778	Eukaryota;Ochrophyta;Synurophyceae;Synurales;Mallomonadaceae;Synura_petersenii;
Zotu780	Eukaryota;Alveolata;Dinophyceae;Suessiales;Suessiaceae;unknown_dinoflagellate;
Zotu781	Eukaryota;Ochrophyta;Chrysophyceae;Chromulinales;Chromulinaceae;Pedospumella_sinomuralis;
Zotu782	Eukaryota;Ochrophyta;Synurophyceae;Synurales;Mallomonadaceae;Synura_petersenii;
Zotu783	Eukaryota;Ochrophyta;Chrysophyceae;Chromulinales;Dinobryaceae;Dinobryon_inclinatum;
Zotu784	Eukaryota;Alveolata;Dinophyceae;unknown;unknown;unknown_dinoflagellate;
Zotu785	Eukaryota;Ochrophyta;Dictyochophyceae;Florenciellales;unknown;Florenciella_parvula;
Zotu786	Eukaryota;Arthropoda;Branchiopoda;Diplostraca;Holopediidae;Holopedium_glacialis;
Zotu787	Eukaryota;Ochrophyta;Phaeophyceae;Ectocarpales;Scytosiphonaceae;Petalonia_fascia;
Zotu788	Eukaryota;Arthropoda;Branchiopoda;Diplostraca;Holopediidae;Holopedium_glacialis;
Zotu790	Eukaryota;Arthropoda;Branchiopoda;Diplostraca;Daphniidae;Daphnia_mendotae;
Zotu792	Eukaryota;Arthropoda;Arachnida;Araneae;Clubionidae;Clubiona_circulata;
Zotu793	Eukaryota;Ochrophyta;Raphidophyceae;Actinophryida;Actinophryidae;Actinophrys_sol;
Zotu794	Eukaryota;Ochrophyta;Chrysophyceae;Chromulinales;Chromulinaceae;Pedospumella_sinomuralis;
Zotu796	Eukaryota;Ochrophyta;Chrysophyceae;Chromulinales;Chromulinaceae;Pedospumella_sinomuralis;
Zotu799	Eukaryota;Rhodophyta;Bangiophyceae;Bangiales;Bangiaceae;Neoporphyra_haitanensis;
Zotu800	Eukaryota;Oomycota;Oomycetes;Pythiales;Pythiaceae;Pythium_spp.;
Zotu803	Eukaryota;Chlorophyta;Trebouxiophyceae;Chlorellales;Chlorellaceae;Marvania_coccoides;
Zotu804	Eukaryota;Ochrophyta;Phaeophyceae;Ectocarpales;Chordariaceae;Chordaria_chordaeformis;
Zotu806	Eukaryota;Ochrophyta;Phaeophyceae;Ectocarpales;Chordariaceae;Microspongium_tenuissimum;
Zotu807	Eukaryota;Ochrophyta;Chrysophyceae;Chromulinales;Chromulinaceae;Pedospumella_sinomuralis;
Zotu808	Eukaryota;Ochrophyta;Chrysophyceae;Chromulinales;Chromulinaceae;Pedospumella_sinomuralis;
Zotu809	Eukaryota;Oomycota;Oomycetes;Saprolegniales;Saprolegniaceae;Saprolegnia_anisospora;
Zotu811	Eukaryota;Ochrophyta;Phaeophyceae;Laminariales;Alariaceae;Pleurophycus_gardneri;
Zotu812	Eukaryota;Ochrophyta;Chrysophyceae;Chromulinales;Chromulinaceae;Pedospumella_sinomuralis;
Zotu815	Eukaryota;Rotifera;Eurotatoria;Ploima;Brachionidae;Euchlanis_dilatata;
Zotu817	Eukaryota;Ochrophyta;Phaeophyceae;Ectocarpales;Chordariaceae;Chordaria_chordaeformis;
Zotu818	Eukaryota;Ochrophyta;Phaeophyceae;Ectocarpales;Chordariaceae;Chordaria_chordaeformis;
Zotu819	Eukaryota;Ochrophyta;Synurophyceae;Synurales;Mallomonadaceae;Synura_synuroidea;
Zotu820	Eukaryota;Ochrophyta;Chrysophyceae;Chromulinales;Dinobryaceae;Dinobryon_cylindricum;
Zotu822	Eukaryota;Ochrophyta;Chrysophyceae;Chromulinales;Dinobryaceae;Dinobryon_inclinatum;
Zotu823	Eukaryota;Arthropoda;Branchiopoda;Diplostraca;Holopediidae;Holopedium_glacialis;
Zotu824	Eukaryota;Rotifera;Eurotatoria;Ploima;Brachionidae;Keratella_spp.;
Zotu825	Eukaryota;Ochrophyta;Synurophyceae;Ochromonadales;Ochromonadaceae;Poterioochromonas_malhamensis;
Zotu826	Eukaryota;Ochrophyta;Synurophyceae;Ochromonadales;Ochromonadaceae;Poterioochromonas_malhamensis;
Zotu829	Eukaryota;Rotifera;Eurotatoria;Ploima;Brachionidae;Brachionus_spp.;
Zotu830	Eukaryota;Alveolata;Dinophyceae;unknown;unknown;unknown_dinoflagellate;
Zotu831	Eukaryota;Arthropoda;Hexanauplia;Calanoida;Pontellidae;unknown_copepod;
Zotu832	Eukaryota;Ochrophyta;Phaeophyceae;Dictyotales;Dictyotaceae;Dictyota_guineensis;
Zotu833	Eukaryota;Rotifera;Eurotatoria;Ploima;Synchaetidae;Synchaeta_gyrina;
Zotu834	Eukaryota;Tracheophyta;Lycopodiopsida;Lycopodiales;Lycopodiaceae;Phlegmariurus_squarrosus;
Zotu835	Eukaryota;Rotifera;Eurotatoria;Ploima;Brachionidae;Euchlanis_dilatata;
Zotu836	Eukaryota;Ochrophyta;Chrysophyceae;Chromulinales;Dinobryaceae;Dinobryon_cylindricollarium;
Zotu838	Eukaryota;Arthropoda;Hexanauplia;Calanoida;Diaptomidae;Leptodiaptomus_minutus;
Zotu839	Eukaryota;Ochrophyta;Phaeophyceae;Ectocarpales;Chordariaceae;Leptonematella_fasciculata;
Zotu840	Eukaryota;Arthropoda;Hexanauplia;Calanoida;Diaptomidae;Leptodiaptomus_minutus;
Zotu841	Eukaryota;Ochrophyta;Chrysophyceae;Chromulinales;Dinobryaceae;Dinobryon_sociale;
Zotu842	Eukaryota;Porifera;Demospongiae;Bubarida;Dictyonellidae;Scopalina_ruetzleri;
Zotu843	Eukaryota;Ochrophyta;Synurophyceae;Ochromonadales;Ochromonadaceae;Cornospumella_fuschlensis;
Zotu845	Bacteria;Pseudomonadota;Alphaproteobacteria;Rickettsiales;Rickettsiaceae;unknown_bacterium;
Zotu846	Eukaryota;Ochrophyta;Synurophyceae;Ochromonadales;Ochromonadaceae;Poterioochromonas_malhamensis;
Zotu847	Eukaryota;Ochrophyta;Chrysophyceae;Chromulinales;Dinobryaceae;Dinobryon_balticum;
Zotu850	Eukaryota;Ochrophyta;Synurophyceae;Ochromonadales;Ochromonadaceae;Poterioochromonas_malhamensis;
Zotu852	Eukaryota;Ochrophyta;Chrysophyceae;Chromulinales;Chromulinaceae;Pedospumella_sinomuralis;
Zotu853	Eukaryota;Ochrophyta;Phaeophyceae;Dictyotales;Dictyotaceae;Dictyota_spiralis;
Zotu854	Eukaryota;Ochrophyta;Coscinodiscophyceae;Melosirales;Stephanopyxidaceae;Stephanopyxis_turris;
Zotu857	Eukaryota;Ochrophyta;Phaeophyceae;Ectocarpales;Scytosiphonaceae;Colpomenia_sinuosa;
Zotu858	Eukaryota;Ochrophyta;Eustigmatophyceae;Goniochloridales;Goniochloridaceae;Trachydiscus_minutus;
Zotu860	Eukaryota;Rotifera;Eurotatoria;Ploima;Brachionidae;Brachionus_spp.;
Zotu861	Eukaryota;Rotifera;Eurotatoria;Ploima;Trichocercidae;Trichocerca_spp.;
Zotu862	Eukaryota;Ochrophyta;Phaeophyceae;Ectocarpales;Scytosiphonaceae;Petalonia_fascia;
Zotu863	Eukaryota;Mollusca;Gastropoda;Stylommatophora;Camaenidae;Amphidromus_dautzenbergi;
Zotu864	Bacteria;Pseudomonadota;Alphaproteobacteria;Rickettsiales;Rickettsiaceae;unknown_bacterium;
Zotu865	Eukaryota;Rotifera;Eurotatoria;unknown;unknown;Rotaria_macrura;
Zotu866	Eukaryota;Charophyta;Zygnemophyceae;Desmidiales;Closteriaceae;Closterium_baillyanum;
Zotu867	Eukaryota;Ochrophyta;Mediophyceae;Hemiaulales;Hemiaulaceae;unknown_microalga;
Zotu868	Eukaryota;Oomycota;Oomycetes;Peronosporales;Peronosporaceae;Phytophthora_lagoariana;
Zotu870	Eukaryota;Rotifera;Eurotatoria;Ploima;Brachionidae;Keratella_cochlearis;
Zotu872	Eukaryota;Charophyta;Zygnemophyceae;Desmidiales;Closteriaceae;Closterium_baillyanum;
Zotu873	Eukaryota;Ochrophyta;Phaeophyceae;Ectocarpales;Chordariaceae;unknown_ochrophyte;
Zotu874	Eukaryota;Tracheophyta;Lycopodiopsida;Lycopodiales;Lycopodiaceae;Phlegmariurus_squarrosus;
Zotu875	Eukaryota;Ochrophyta;Chrysophyceae;Chromulinales;Dinobryaceae;Dinobryon_cylindricollarium;
Zotu877	Eukaryota;Rotifera;Eurotatoria;Ploima;Brachionidae;Euchlanis_dilatata;
Zotu878	Eukaryota;Ochrophyta;Chrysophyceae;Chromulinales;Dinobryaceae;Dinobryon_similis;
Zotu879	Eukaryota;Charophyta;Zygnemophyceae;Desmidiales;Closteriaceae;Closterium_baillyanum;
Zotu880	Eukaryota;Ochrophyta;Phaeophyceae;Ectocarpales;Chordariaceae;Chordaria_chordaeformis;
Zotu882	Eukaryota;Rotifera;Eurotatoria;Ploima;Synchaetidae;Polyarthra_spp.;
Zotu883	Eukaryota;Rotifera;Eurotatoria;Ploima;Brachionidae;Kellicottia_bostoniensis;
Zotu884	Eukaryota;Ochrophyta;Chrysophyceae;Chromulinales;Chromulinaceae;Pedospumella_spp.;
Zotu885	Eukaryota;Alveolata;Dinophyceae;unknown;unknown;unknown_dinoflagellate;
Zotu886	Eukaryota;Ochrophyta;Chrysophyceae;Chromulinales;Chromulinaceae;Pedospumella_sinomuralis;
Zotu887	Eukaryota;Alveolata;Dinophyceae;unknown;unknown;unknown_dinoflagellate;
Zotu888	Eukaryota;Ochrophyta;Phaeophyceae;Dictyotales;Dictyotaceae;Dictyota_spp.;
Zotu890	Eukaryota;Ochrophyta;Bacillariophyceae;Naviculales;Sellaphoraceae;Sellaphora_seminulum;
Zotu891	Eukaryota;Oomycota;Oomycetes;Pythiales;Pythiaceae;Globisporangium_irregulare;
Zotu892	Eukaryota;Rotifera;Eurotatoria;Ploima;Brachionidae;Euchlanis_dilatata;
Zotu894	Eukaryota;Ochrophyta;Phaeophyceae;Ectocarpales;Chordariaceae;Leptonematella_fasciculata;
Zotu895	Eukaryota;Ochrophyta;Eustigmatophyceae;Eustigmatales;Monodopsidaceae;Nannochloropsis_limnetica;
Zotu896	Eukaryota;Ochrophyta;Synurophyceae;Synurales;Mallomonadaceae;Mallomonas_spp.;
Zotu898	Eukaryota;Arthropoda;Branchiopoda;Diplostraca;Holopediidae;Holopedium_glacialis;
Zotu900	Eukaryota;Ochrophyta;Phaeophyceae;Ectocarpales;Chordariaceae;Chordaria_chordaeformis;
Zotu902	Eukaryota;Ochrophyta;Chrysophyceae;Chromulinales;Dinobryaceae;Epipyxis_spp.;
Zotu903	Eukaryota;Rotifera;Eurotatoria;Ploima;Synchaetidae;Polyarthra_spp.;
Zotu904	Eukaryota;Ochrophyta;Chrysophyceae;Chromulinales;Dinobryaceae;Dinobryon_sertularia;
Zotu906	Eukaryota;Ochrophyta;Synurophyceae;Synurales;Mallomonadaceae;Synura_synuroidea;
Zotu908	Eukaryota;Rotifera;Eurotatoria;Ploima;Brachionidae;Brachionus_calyciflorus;
Zotu909	Eukaryota;Rotifera;Eurotatoria;Ploima;Brachionidae;Keratella_cochlearis;
Zotu910	Eukaryota;Ochrophyta;Chrysophyceae;Chromulinales;Chromulinaceae;Pedospumella_sinomuralis;
Zotu911	Eukaryota;Alveolata;Dinophyceae;unknown;unknown;unknown_dinoflagellate;
Zotu912	Eukaryota;Rotifera;Eurotatoria;Ploima;Brachionidae;Keratella_cochlearis;
Zotu913	Eukaryota;Ochrophyta;Chrysophyceae;Chromulinales;Dinobryaceae;Dinobryon_inclinatum;
Zotu914	Eukaryota;Rotifera;Eurotatoria;Ploima;Brachionidae;Euchlanis_dilatata;
Zotu915	Eukaryota;Arthropoda;Hexanauplia;Calanoida;Diaptomidae;Leptodiaptomus_minutus;
Zotu916	Eukaryota;Mollusca;Gastropoda;unknown;Pachychilidae;Sulcospira_paludiformis;
Zotu917	Eukaryota;Rotifera;Eurotatoria;Ploima;Synchaetidae;Polyarthra_spp.;
Zotu918	Eukaryota;Rotifera;Eurotatoria;Ploima;Trichocercidae;unknown_rotifer;
Zotu921	Eukaryota;Cnidaria;Scyphozoa;Semaeostomeae;Cyaneidae;Cyanea_capillata;
Zotu922	Eukaryota;Rotifera;Eurotatoria;Ploima;Brachionidae;Keratella_cochlearis;
Zotu923	Eukaryota;Ochrophyta;Phaeophyceae;Ectocarpales;Chordariaceae;Laminarionema_elsbetiae;
Zotu924	Eukaryota;Ochrophyta;Synurophyceae;Synurales;Mallomonadaceae;Synura_petersenii;
Zotu927	Eukaryota;Ochrophyta;Raphidophyceae;Chattonellales;Chattonellaceae;Chattonella_marina;
